Index	Date	Hour	Original	Predicted	Error	Relative Error
102	5/5/2014	5	792	894	-102	-0.129500424
103	5/5/2014	6	1101	982	119	0.107453363
104	5/5/2014	7	973	1100	-127	-0.13111619
105	5/5/2014	8	964	927	37	0.038360022
106	5/5/2014	9	1062	979	83	0.078078335
107	5/5/2014	10	880	1038	-158	-0.179996679
108	5/5/2014	11	1009	908	101	0.09975705
109	5/5/2014	12	794	874	-80	-0.101455335
110	5/5/2014	13	868	785	83	0.094710172
111	5/5/2014	14	837	896	-59	-0.070861842
112	5/5/2014	15	966	826	140	0.144915926
113	5/5/2014	16	1017	946	71	0.068937784
114	5/5/2014	17	1041	942	99	0.094997894
115	5/5/2014	18	766	794	-28	-0.037575361
116	5/5/2014	19	405	445	-40	-0.099481423
117	5/5/2014	20	196	227	-31	-0.160352082
118	5/5/2014	21	97	96	1	0.005900162
119	5/5/2014	22	60	58	2	0.029857651
120	5/5/2014	23	56	42	14	0.243211911
121	5/6/2014	0	66	69	-3	-0.054919812
122	5/6/2014	1	161	158	3	0.015366082
123	5/6/2014	2	320	291	29	0.08852604
124	5/6/2014	3	451	467	-16	-0.036116682
125	5/6/2014	4	712	689	23	0.032045722
126	5/6/2014	5	940	960	-20	-0.022012679
127	5/6/2014	6	1048	1147	-99	-0.095015583
128	5/6/2014	7	1115	1032	83	0.074393216
129	5/6/2014	8	1022	1057	-35	-0.034711069
130	5/6/2014	9	1051	1060	-9	-0.008656856
131	5/6/2014	10	1065	986	79	0.073375362
132	5/6/2014	11	1006	1071	-65	-0.064741959
133	5/6/2014	12	1041	852	189	0.181138523
134	5/6/2014	13	956	968	-12	-0.012641866
135	5/6/2014	14	929	944	-15	-0.016531203
136	5/6/2014	15	996	924	72	0.071496874
137	5/6/2014	16	996	966	30	0.029196765
138	5/6/2014	17	1033	977	56	0.054029752
139	5/6/2014	18	774	769	5	0.005957719
140	5/6/2014	19	484	459	25	0.049642684
141	5/6/2014	20	243	248	-5	-0.023054774
142	5/6/2014	21	108	115	-7	-0.072462975
143	5/6/2014	22	69	64	5	0.071589902
144	5/6/2014	23	46	49	-3	-0.086946949
145	5/7/2014	0	71	59	12	0.165716414
146	5/7/2014	1	170	174	-4	-0.02396706
147	5/7/2014	2	263	315	-52	-0.199041231
148	5/7/2014	3	421	409	12	0.02701961
149	5/7/2014	4	643	659	-16	-0.02565971
150	5/7/2014	5	889	898	-9	-0.010875869
151	5/7/2014	6	1082	1103	-21	-0.019650504
152	5/7/2014	7	1045	1084	-39	-0.037771495
153	5/7/2014	8	829	994	-165	-0.200037248
154	5/7/2014	9	1032	905	127	0.122558706
155	5/7/2014	10	1190	961	229	0.191877429
156	5/7/2014	11	1087	1187	-100	-0.092458533
157	5/7/2014	12	1042	940	102	0.097367955
158	5/7/2014	13	917	956	-39	-0.043228957
159	5/7/2014	14	973	915	58	0.058843617
160	5/7/2014	15	928	989	-61	-0.066120834
161	5/7/2014	16	917	938	-21	-0.023588507
162	5/7/2014	17	968	935	33	0.033989627
163	5/7/2014	18	814	733	81	0.098876042
164	5/7/2014	19	397	484	-87	-0.221634224
165	5/7/2014	20	225	210	15	0.065332896
166	5/7/2014	21	116	104	12	0.100212162
167	5/7/2014	22	47	65	-18	-0.4021659
168	5/7/2014	23	52	38	14	0.255726681
169	5/8/2014	0	58	67	-9	-0.162507025
170	5/8/2014	1	176	144	32	0.176275061
171	5/8/2014	2	262	327	-65	-0.248391328
172	5/8/2014	3	443	393	50	0.112375047
173	5/8/2014	4	680	681	-1	-0.002429485
174	5/8/2014	5	984	922	62	0.062090171
175	5/8/2014	6	1152	1197	-45	-0.039490946
176	5/8/2014	7	1141	1098	43	0.036918272
177	5/8/2014	8	950	1017	-67	-0.070896606
178	5/8/2014	9	1057	1027	30	0.027465364
179	5/8/2014	10	1126	1033	93	0.082288128
180	5/8/2014	11	925	1133	-208	-0.225108203
181	5/8/2014	12	909	892	17	0.018510334
182	5/8/2014	13	965	888	77	0.078974829
183	5/8/2014	14	899	979	-80	-0.089789315
184	5/8/2014	15	836	962	-126	-0.151567499
185	5/8/2014	16	869	869	0	-7.50E-05
186	5/8/2014	17	843	929	-86	-0.102952857
187	5/8/2014	18	678	684	-6	-0.009631237
188	5/8/2014	19	338	395	-57	-0.169425566
189	5/8/2014	20	174	186	-12	-0.070393996
190	5/8/2014	21	90	91	-1	-0.012199195
191	5/8/2014	22	66	49	17	0.248464892
192	5/8/2014	23	46	56	-10	-0.228748078
193	5/9/2014	0	61	58	3	0.038414643
194	5/9/2014	1	100	155	-55	-0.559953684
195	5/9/2014	2	231	187	44	0.187179169
196	5/9/2014	3	330	391	-61	-0.186611462
197	5/9/2014	4	527	557	-30	-0.057858498
198	5/9/2014	5	615	761	-146	-0.237611531
199	5/9/2014	6	855	804	51	0.058753794
200	5/9/2014	7	872	893	-21	-0.025094387
201	5/9/2014	8	788	802	-14	-0.018123905
202	5/9/2014	9	849	912	-63	-0.0752033
203	5/9/2014	10	697	879	-182	-0.261443794
204	5/9/2014	11	908	720	188	0.206245441
205	5/9/2014	12	744	873	-129	-0.17464683
206	5/9/2014	13	770	769	1	0.000214387
207	5/9/2014	14	776	784	-8	-0.010844716
208	5/9/2014	15	696	803	-107	-0.154233716
209	5/9/2014	16	737	746	-9	-0.013361023
210	5/9/2014	17	777	798	-21	-0.027991763
211	5/9/2014	18	533	637	-104	-0.196774146
212	5/9/2014	19	352	306	46	0.127880342
213	5/9/2014	20	180	184	-4	-0.022493614
214	5/9/2014	21	100	92	8	0.078630194
215	5/9/2014	22	60	57	3	0.049283861
216	5/9/2014	23	43	49	-6	-0.148857997
217	5/10/2014	0	57	54	3	0.036100483
218	5/10/2014	1	116	133	-17	-0.148319815
219	5/10/2014	2	218	222	-4	-0.021155547
220	5/10/2014	3	343	350	-7	-0.021880045
221	5/10/2014	4	520	566	-46	-0.089389744
222	5/10/2014	5	742	715	27	0.035114418
223	5/10/2014	6	903	927	-24	-0.026983608
224	5/10/2014	7	986	934	52	0.052661699
225	5/10/2014	8	922	849	73	0.078812409
226	5/10/2014	9	949	1009	-60	-0.06365205
227	5/10/2014	10	817	959	-142	-0.175005386
228	5/10/2014	11	834	821	13	0.01502734
229	5/10/2014	12	833	826	7	0.008399872
230	5/10/2014	13	688	854	-166	-0.24242384
231	5/10/2014	14	696	724	-28	-0.040635176
232	5/10/2014	15	708	705	3	0.003906935
233	5/10/2014	16	630	773	-143	-0.227546187
234	5/10/2014	17	627	700	-73	-0.117820661
235	5/10/2014	18	535	521	14	0.025981322
236	5/10/2014	19	374	319	55	0.144688076
237	5/10/2014	20	175	200	-25	-0.146763519
238	5/10/2014	21	101	90	11	0.102694129
239	5/10/2014	22	64	57	7	0.097239782
240	5/10/2014	23	22	48	-26	-1.201786235
241	5/11/2014	0	55	34	21	0.368139419
242	5/11/2014	1	97	123	-26	-0.268774205
243	5/11/2014	2	185	198	-13	-0.073796751
244	5/11/2014	3	308	314	-6	-0.020403298
245	5/11/2014	4	513	478	35	0.066583682
246	5/11/2014	5	696	724	-28	-0.040294243
247	5/11/2014	6	764	881	-117	-0.153419508
248	5/11/2014	7	858	815	43	0.049628911
249	5/11/2014	8	831	758	73	0.087463137
250	5/11/2014	9	738	937	-199	-0.27045727
251	5/11/2014	10	782	749	33	0.042106356
252	5/11/2014	11	721	802	-81	-0.112573415
253	5/11/2014	12	695	716	-21	-0.030616909
254	5/11/2014	13	702	698	4	0.005682005
255	5/11/2014	14	747	732	15	0.01984129
256	5/11/2014	15	670	714	-44	-0.065735002
257	5/11/2014	16	657	676	-19	-0.029078277
258	5/11/2014	17	760	701	59	0.077625634
259	5/11/2014	18	605	585	20	0.032809616
260	5/11/2014	19	399	358	41	0.101939832
261	5/11/2014	20	188	199	-11	-0.063252674
262	5/11/2014	21	85	99	-14	-0.174136239
263	5/11/2014	22	36	50	-14	-0.400025387
264	5/11/2014	23	25	26	-1	-0.070883212
265	5/12/2014	0	46	41	5	0.0883124
266	5/12/2014	1	122	101	21	0.164553427
267	5/12/2014	2	242	233	9	0.034228978
268	5/12/2014	3	345	362	-17	-0.051888829
269	5/12/2014	4	533	525	8	0.014914406
270	5/12/2014	5	743	703	40	0.052856377
271	5/12/2014	6	895	905	-10	-0.01117376
272	5/12/2014	7	1003	950	53	0.052376708
273	5/12/2014	8	991	908	83	0.082811271
274	5/12/2014	9	1011	997	14	0.012886071
275	5/12/2014	10	997	926	71	0.070991504
276	5/12/2014	11	983	957	26	0.025797313
277	5/12/2014	12	885	904	-19	-0.022479151
278	5/12/2014	13	823	847	-24	-0.029925147
279	5/12/2014	14	851	820	31	0.035905077
280	5/12/2014	15	816	801	15	0.017409751
281	5/12/2014	16	972	803	169	0.173582488
282	5/12/2014	17	921	939	-18	-0.019746702
283	5/12/2014	18	705	708	-3	-0.004808613
284	5/12/2014	19	384	425	-41	-0.109036989
285	5/12/2014	20	185	187	-2	-0.015383365
286	5/12/2014	21	113	99	14	0.12075433
287	5/12/2014	22	71	65	6	0.079883245
288	5/12/2014	23	47	39	8	0.162429933
289	5/13/2014	0	68	75	-7	-0.112535371
290	5/13/2014	1	127	131	-4	-0.034434249
291	5/13/2014	2	260	246	14	0.052895816
292	5/13/2014	3	414	391	23	0.054251775
293	5/13/2014	4	665	644	21	0.030863563
294	5/13/2014	5	813	864	-51	-0.063125166
295	5/13/2014	6	1022	986	36	0.034387603
296	5/13/2014	7	996	1109	-113	-0.11399704
297	5/13/2014	8	876	960	-84	-0.096990883
298	5/13/2014	9	987	895	92	0.092596567
299	5/13/2014	10	938	923	15	0.01532499
300	5/13/2014	11	968	987	-19	-0.020074845
301	5/13/2014	12	815	873	-58	-0.071740943
302	5/13/2014	13	697	772	-75	-0.107989478
303	5/13/2014	14	837	748	89	0.106190478
304	5/13/2014	15	857	791	66	0.076210069
305	5/13/2014	16	835	868	-33	-0.0406595
306	5/13/2014	17	770	863	-93	-0.121451473
307	5/13/2014	18	599	592	7	0.011597087
308	5/13/2014	19	372	385	-13	-0.037263085
309	5/13/2014	20	192	185	7	0.034729649
310	5/13/2014	21	88	105	-17	-0.200149174
311	5/13/2014	22	48	51	-3	-0.079623323
312	5/13/2014	23	44	29	15	0.326058254
313	5/14/2014	0	61	71	-10	-0.164858914
314	5/14/2014	1	119	124	-5	-0.043287618
315	5/14/2014	2	233	226	7	0.029156837
316	5/14/2014	3	421	359	62	0.146232308
317	5/14/2014	4	619	668	-49	-0.079468713
318	5/14/2014	5	813	820	-7	-0.008900238
319	5/14/2014	6	976	938	38	0.038270639
320	5/14/2014	7	952	1029	-77	-0.080952715
321	5/14/2014	8	853	919	-66	-0.07783411
322	5/14/2014	9	908	886	22	0.023805613
323	5/14/2014	10	851	898	-47	-0.05588598
324	5/14/2014	11	850	869	-19	-0.023352934
325	5/14/2014	12	686	790	-104	-0.152627647
326	5/14/2014	13	652	645	7	0.010246543
327	5/14/2014	14	672	725	-53	-0.080280065
328	5/14/2014	15	708	694	14	0.019205036
329	5/14/2014	16	179	734	-555	-3.10204596
330	5/14/2014	17	1	244	-243	-243.8526737
331	5/14/2014	18	6	3	3	0.369173996
332	5/14/2014	19	15	12	3	0.146240967
333	5/14/2014	20	110	23	87	0.786354756
334	5/14/2014	21	93	69	24	0.252136333
335	5/14/2014	22	50	33	17	0.33276119
336	5/14/2014	23	40	21	19	0.461854625
337	5/15/2014	0	53	48	5	0.084298884
338	5/15/2014	1	117	92	25	0.205138545
339	5/15/2014	2	238	197	41	0.171171068
340	5/15/2014	3	355	374	-19	-0.055305367
341	5/15/2014	4	537	575	-38	-0.07185616
342	5/15/2014	5	663	696	-33	-0.050072041
343	5/15/2014	6	830	831	-1	-0.0017835
344	5/15/2014	7	859	894	-35	-0.040888766
345	5/15/2014	8	896	806	90	0.100080934
346	5/15/2014	9	968	858	110	0.112765283
347	5/15/2014	10	918	901	17	0.017914996
348	5/15/2014	11	774	911	-137	-0.17705295
349	5/15/2014	12	705	571	134	0.189484227
350	5/15/2014	13	726	625	101	0.138258328
351	5/15/2014	14	694	813	-119	-0.172337643
352	5/15/2014	15	712	697	15	0.020783969
353	5/15/2014	16	780	466	314	0.401507902
354	5/15/2014	17	754	187	567	0.751875489
355	5/15/2014	18	566	645	-79	-0.140963723
356	5/15/2014	19	296	378	-82	-0.278581463
357	5/15/2014	20	188	261	-73	-0.392674466
358	5/15/2014	21	98	107	-9	-0.09628037
359	5/15/2014	22	44	57	-13	-0.300605262
360	5/15/2014	23	37	34	3	0.056546691
361	5/16/2014	0	55	58	-3	-0.061763551
362	5/16/2014	1	133	136	-3	-0.027444945
363	5/16/2014	2	229	296	-67	-0.293163512
364	5/16/2014	3	246	374	-128	-0.522857968
365	5/16/2014	4	334	418	-84	-0.251776658
366	5/16/2014	5	477	514	-37	-0.079031577
367	5/16/2014	6	572	678	-106	-0.185693758
368	5/16/2014	7	643	678	-35	-0.054699385
369	5/16/2014	8	568	686	-118	-0.209133088
370	5/16/2014	9	615	711	-96	-0.157577907
371	5/16/2014	10	694	659	35	0.049093722
372	5/16/2014	11	659	690	-31	-0.047894774
373	5/16/2014	12	628	705	-77	-0.123315646
374	5/16/2014	13	600	641	-41	-0.069973268
375	5/16/2014	14	623	631	-8	-0.014349676
376	5/16/2014	15	666	663	3	0.004079577
377	5/16/2014	16	633	544	89	0.14037818
378	5/16/2014	17	612	145	467	0.762515644
379	5/16/2014	18	490	595	-105	-0.215069326
380	5/16/2014	19	283	304	-21	-0.077182903
381	5/16/2014	20	152	214	-62	-0.409624485
382	5/16/2014	21	78	87	-9	-0.121637247
383	5/16/2014	22	53	50	3	0.053523165
384	5/16/2014	23	40	49	-9	-0.237660972
385	5/17/2014	0	55	62	-7	-0.127994621
386	5/17/2014	1	105	112	-7	-0.073776749
387	5/17/2014	2	196	199	-3	-0.018611331
388	5/17/2014	3	323	296	27	0.081003157
389	5/17/2014	4	541	481	60	0.109197152
390	5/17/2014	5	658	689	-31	-0.04807047
391	5/17/2014	6	776	813	-37	-0.048194646
392	5/17/2014	7	815	797	18	0.021010477
393	5/17/2014	8	793	747	46	0.057029784
394	5/17/2014	9	740	847	-107	-0.145792496
395	5/17/2014	10	752	751	1	0.000740941
396	5/17/2014	11	778	738	40	0.050967392
397	5/17/2014	12	696	670	26	0.037245366
398	5/17/2014	13	679	659	20	0.029378606
399	5/17/2014	14	704	708	-4	-0.006975412
400	5/17/2014	15	662	727	-65	-0.098245401
401	5/17/2014	16	676	476	200	0.295266298
402	5/17/2014	17	622	177	445	0.714281958
403	5/17/2014	18	455	565	-110	-0.243576035
404	5/17/2014	19	300	295	5	0.013924313
405	5/17/2014	20	169	252	-83	-0.492162781
406	5/17/2014	21	85	94	-9	-0.113909554
407	5/17/2014	22	61	52	9	0.146509311
408	5/17/2014	23	28	51	-23	-0.851416791
409	5/18/2014	0	44	45	-1	-0.043209304
410	5/18/2014	1	102	103	-1	-0.016257838
411	5/18/2014	2	222	218	4	0.017479233
412	5/18/2014	3	316	346	-30	-0.095570442
413	5/18/2014	4	465	474	-9	-0.020316843
414	5/18/2014	5	478	616	-138	-0.290199956
415	5/18/2014	6	593	614	-21	-0.036082115
416	5/18/2014	7	565	665	-100	-0.177757747
417	5/18/2014	8	676	597	79	0.115511097
418	5/18/2014	9	742	761	-19	-0.026196094
419	5/18/2014	10	707	775	-68	-0.096593486
420	5/18/2014	11	691	676	15	0.020429106
421	5/18/2014	12	712	665	47	0.064608473
422	5/18/2014	13	647	708	-61	-0.09498022
423	5/18/2014	14	735	654	81	0.109225364
424	5/18/2014	15	705	730	-25	-0.036182435
425	5/18/2014	16	757	536	221	0.290902519
426	5/18/2014	17	759	207	552	0.72638456
427	5/18/2014	18	522	646	-124	-0.238493406
428	5/18/2014	19	311	317	-6	-0.019688971
429	5/18/2014	20	132	234	-102	-0.779353573
430	5/18/2014	21	81	78	3	0.032782383
431	5/18/2014	22	40	54	-14	-0.369622883
432	5/18/2014	23	27	33	-6	-0.246249993
433	5/19/2014	0	45	45	0	-0.000557311
434	5/19/2014	1	89	103	-14	-0.159722671
435	5/19/2014	2	226	186	40	0.174421196
436	5/19/2014	3	349	309	40	0.114007671
437	5/19/2014	4	535	501	34	0.06209053
438	5/19/2014	5	784	611	173	0.219396432
439	5/19/2014	6	909	853	56	0.060599152
440	5/19/2014	7	955	890	65	0.067031582
441	5/19/2014	8	926	907	19	0.020075877
442	5/19/2014	9	1020	913	107	0.10394823
443	5/19/2014	10	931	981	-50	-0.054080294
444	5/19/2014	11	874	867	7	0.008005143
445	5/19/2014	12	799	808	-9	-0.011868887
446	5/19/2014	13	709	767	-58	-0.081937036
447	5/19/2014	14	744	757	-13	-0.018155029
448	5/19/2014	15	726	739	-13	-0.019173891
449	5/19/2014	16	844	768	76	0.089534241
450	5/19/2014	17	815	795	20	0.024142201
451	5/19/2014	18	559	588	-29	-0.053170884
452	5/19/2014	19	318	326	-8	-0.028066587
453	5/19/2014	20	148	167	-19	-0.13044958
454	5/19/2014	21	94	82	12	0.125673736
455	5/19/2014	22	53	55	-2	-0.045253046
456	5/19/2014	23	36	35	1	0.013530928
457	5/20/2014	0	50	54	-4	-0.090752693
458	5/20/2014	1	125	108	17	0.128229092
459	5/20/2014	2	238	254	-16	-0.067605263
460	5/20/2014	3	364	337	27	0.073934918
461	5/20/2014	4	578	544	34	0.058229772
462	5/20/2014	5	742	708	34	0.045302218
463	5/20/2014	6	891	863	28	0.031068516
464	5/20/2014	7	900	881	19	0.020375605
465	5/20/2014	8	835	873	-38	-0.04599984
466	5/20/2014	9	886	874	12	0.012458641
467	5/20/2014	10	892	876	16	0.017600606
468	5/20/2014	11	849	865	-16	-0.020018048
469	5/20/2014	12	723	802	-79	-0.110081231
470	5/20/2014	13	720	680	40	0.054664578
471	5/20/2014	14	755	764	-9	-0.01268108
472	5/20/2014	15	695	751	-56	-0.081510193
473	5/20/2014	16	745	743	2	0.002504012
474	5/20/2014	17	719	726	-7	-0.010744486
475	5/20/2014	18	529	528	1	0.000110835
476	5/20/2014	19	320	315	5	0.014367327
477	5/20/2014	20	186	158	28	0.149442651
478	5/20/2014	21	89	101	-12	-0.143747531
479	5/20/2014	22	60	53	7	0.114723794
480	5/20/2014	23	47	36	11	0.223042765
481	5/21/2014	0	43	65	-22	-0.519280789
482	5/21/2014	1	133	96	37	0.27604814
483	5/21/2014	2	254	265	-11	-0.045060837
484	5/21/2014	3	363	391	-28	-0.079756507
485	5/21/2014	4	565	567	-2	-0.003983367
486	5/21/2014	5	638	689	-51	-0.08131203
487	5/21/2014	6	797	791	6	0.007292118
488	5/21/2014	7	889	823	66	0.073898657
489	5/21/2014	8	770	895	-125	-0.16291323
490	5/21/2014	9	854	825	29	0.032920893
491	5/21/2014	10	831	829	2	0.001377206
492	5/21/2014	11	846	820	26	0.029693426
493	5/21/2014	12	828	779	49	0.058610407
494	5/21/2014	13	636	760	-124	-0.195085831
495	5/21/2014	14	700	696	4	0.005064919
496	5/21/2014	15	712	682	30	0.040737816
497	5/21/2014	16	714	783	-69	-0.09761304
498	5/21/2014	17	695	706	-11	-0.017026263
499	5/21/2014	18	488	508	-20	-0.041087953
500	5/21/2014	19	287	302	-15	-0.054896418
501	5/21/2014	20	163	148	15	0.086895721
502	5/21/2014	21	98	91	7	0.069351975
503	5/21/2014	22	50	58	-8	-0.166236674
504	5/21/2014	23	20	32	-12	-0.6152086
505	5/22/2014	0	41	30	11	0.254506845
506	5/22/2014	1	100	105	-5	-0.052235006
507	5/22/2014	2	250	227	23	0.090840919
508	5/22/2014	3	368	368	0	-0.000277914
509	5/22/2014	4	558	541	17	0.030169679
510	5/22/2014	5	695	675	20	0.027709235
511	5/22/2014	6	769	826	-57	-0.07514511
512	5/22/2014	7	758	802	-44	-0.058542503
513	5/22/2014	8	694	755	-61	-0.089120095
514	5/22/2014	9	752	796	-44	-0.058708682
515	5/22/2014	10	754	764	-10	-0.014360278
516	5/22/2014	11	761	760	1	0.0003754
517	5/22/2014	12	661	733	-72	-0.109755911
518	5/22/2014	13	589	609	-20	-0.034398959
519	5/22/2014	14	590	654	-64	-0.108632353
520	5/22/2014	15	647	595	52	0.079255745
521	5/22/2014	16	674	724	-50	-0.074341591
522	5/22/2014	17	623	686	-63	-0.101792241
523	5/22/2014	18	480	440	40	0.081503902
524	5/22/2014	19	305	289	16	0.051663515
525	5/22/2014	20	163	158	5	0.025446059
526	5/22/2014	21	85	91	-6	-0.081947109
527	5/22/2014	22	41	47	-6	-0.154907688
528	5/22/2014	23	39	26	13	0.318276071
529	5/23/2014	0	50	52	-2	-0.055926382
530	5/23/2014	1	109	124	-15	-0.139872153
531	5/23/2014	2	216	237	-21	-0.098566559
532	5/23/2014	3	303	324	-21	-0.070708055
533	5/23/2014	4	467	504	-37	-0.079709127
534	5/23/2014	5	628	623	5	0.007079797
535	5/23/2014	6	724	771	-47	-0.06552376
536	5/23/2014	7	802	788	14	0.016426514
537	5/23/2014	8	725	754	-29	-0.040611834
538	5/23/2014	9	710	801	-91	-0.129019805
539	5/23/2014	10	682	722	-40	-0.059787997
540	5/23/2014	11	728	706	22	0.028976846
541	5/23/2014	12	699	682	17	0.02372793
542	5/23/2014	13	657	624	33	0.04957505
543	5/23/2014	14	614	689	-75	-0.123153486
544	5/23/2014	15	600	635	-35	-0.059318648
545	5/23/2014	16	638	655	-17	-0.027401125
546	5/23/2014	17	560	627	-67	-0.121422709
547	5/23/2014	18	487	444	43	0.086944865
548	5/23/2014	19	301	298	3	0.009806831
549	5/23/2014	20	133	161	-28	-0.217752854
550	5/23/2014	21	82	77	5	0.058787152
551	5/23/2014	22	47	46	1	0.016431151
552	5/23/2014	23	39	31	8	0.181672424
553	5/24/2014	0	30	52	-22	-0.748109971
554	5/24/2014	1	120	82	38	0.314624697
555	5/24/2014	2	218	240	-22	-0.102638424
556	5/24/2014	3	314	334	-20	-0.066592585
557	5/24/2014	4	458	502	-44	-0.096377919
558	5/24/2014	5	574	581	-7	-0.013790898
559	5/24/2014	6	675	720	-45	-0.066805687
560	5/24/2014	7	742	741	1	0.000359984
561	5/24/2014	8	745	683	62	0.082478359
562	5/24/2014	9	728	787	-59	-0.081494074
563	5/24/2014	10	671	732	-61	-0.091413511
564	5/24/2014	11	696	698	-2	-0.003146004
565	5/24/2014	12	607	653	-46	-0.077021502
566	5/24/2014	13	610	578	32	0.05173432
567	5/24/2014	14	614	633	-19	-0.032067209
568	5/24/2014	15	630	616	14	0.021175853
569	5/24/2014	16	572	660	-88	-0.153890378
570	5/24/2014	17	586	562	24	0.039911031
571	5/24/2014	18	426	462	-36	-0.085553512
572	5/24/2014	19	316	266	50	0.156121156
573	5/24/2014	20	160	167	-7	-0.048205219
574	5/24/2014	21	101	88	13	0.125576139
575	5/24/2014	22	46	53	-7	-0.15809081
576	5/24/2014	23	39	32	7	0.156419266
577	5/25/2014	0	52	44	8	0.145601323
578	5/25/2014	1	88	139	-51	-0.587504819
579	5/25/2014	2	172	192	-20	-0.116465735
580	5/25/2014	3	251	265	-14	-0.058069459
581	5/25/2014	4	407	423	-16	-0.040934812
582	5/25/2014	5	566	556	10	0.017369339
583	5/25/2014	6	795	672	123	0.153971354
584	5/25/2014	7	864	840	24	0.026990472
585	5/25/2014	8	712	781	-69	-0.09776104
586	5/25/2014	9	677	725	-48	-0.071560556
587	5/25/2014	10	558	657	-99	-0.177435124
588	5/25/2014	11	552	618	-66	-0.120856754
589	5/25/2014	12	523	561	-38	-0.07388107
590	5/25/2014	13	554	510	44	0.079235298
591	5/25/2014	14	636	585	51	0.078789478
592	5/25/2014	15	671	660	11	0.015917404
593	5/25/2014	16	674	661	13	0.018898607
594	5/25/2014	17	599	607	-8	-0.014652803
595	5/25/2014	18	480	458	22	0.044611565
596	5/25/2014	19	307	318	-11	-0.036302317
597	5/25/2014	20	137	154	-17	-0.127297415
598	5/25/2014	21	59	83	-24	-0.407346048
599	5/25/2014	22	26	33	-7	-0.28768607
600	5/25/2014	23	23	22	1	0.032560622
601	5/26/2014	0	46	32	14	0.296880528
602	5/26/2014	1	100	116	-16	-0.160738403
603	5/26/2014	2	181	200	-19	-0.109126583
604	5/26/2014	3	295	252	43	0.143282426
605	5/26/2014	4	492	450	42	0.08372373
606	5/26/2014	5	714	650	64	0.088511472
607	5/26/2014	6	816	824	-8	-0.010862046
608	5/26/2014	7	830	833	-3	-0.004598618
609	5/26/2014	8	832	740	92	0.109942502
610	5/26/2014	9	910	803	107	0.117296243
611	5/26/2014	10	938	806	132	0.140202128
612	5/26/2014	11	850	896	-46	-0.055168292
613	5/26/2014	12	796	733	63	0.077901126
614	5/26/2014	13	680	740	-60	-0.088429962
615	5/26/2014	14	709	686	23	0.031311752
616	5/26/2014	15	712	724	-12	-0.018042008
617	5/26/2014	16	805	700	105	0.129345061
618	5/26/2014	17	750	728	22	0.028237282
619	5/26/2014	18	551	567	-16	-0.029666043
620	5/26/2014	19	289	352	-63	-0.218851885
621	5/26/2014	20	148	143	5	0.029874429
622	5/26/2014	21	86	82	4	0.043465788
623	5/26/2014	22	51	42	9	0.170703995
624	5/26/2014	23	25	43	-18	-0.731337513
625	5/27/2014	0	67	35	32	0.47461654
626	5/27/2014	1	102	144	-42	-0.415393184
627	5/27/2014	2	216	201	15	0.067326313
628	5/27/2014	3	365	313	52	0.140802771
629	5/27/2014	4	587	539	48	0.081149935
630	5/27/2014	5	769	800	-31	-0.041176289
631	5/27/2014	6	889	894	-5	-0.005872283
632	5/27/2014	7	872	935	-63	-0.073325665
633	5/27/2014	8	811	820	-9	-0.01140965
634	5/27/2014	9	848	832	16	0.018465018
635	5/27/2014	10	898	792	106	0.117682686
636	5/27/2014	11	853	864	-11	-0.013094658
637	5/27/2014	12	740	772	-32	-0.04343414
638	5/27/2014	13	747	690	57	0.074974157
639	5/27/2014	14	747	750	-3	-0.004477659
640	5/27/2014	15	684	759	-75	-0.111037124
641	5/27/2014	16	781	717	64	0.081501296
642	5/27/2014	17	740	723	17	0.02218844
643	5/27/2014	18	563	559	4	0.00653468
644	5/27/2014	19	348	350	-2	-0.008461514
645	5/27/2014	20	173	161	12	0.068556278
646	5/27/2014	21	71	93	-22	-0.320089696
647	5/27/2014	22	32	38	-6	-0.195805041
648	5/27/2014	23	28	25	3	0.07518591
649	5/28/2014	0	53	45	8	0.144121446
650	5/28/2014	1	112	115	-3	-0.031994055
651	5/28/2014	2	180	213	-33	-0.185193117
652	5/28/2014	3	271	278	-7	-0.027929132
653	5/28/2014	4	446	449	-3	-0.007228601
654	5/28/2014	5	604	628	-24	-0.040478847
655	5/28/2014	6	766	754	12	0.01445407
656	5/28/2014	7	647	802	-155	-0.239916146
657	5/28/2014	8	759	649	110	0.144454631
658	5/28/2014	9	929	782	147	0.157542608
659	5/28/2014	10	877	867	10	0.010514948
660	5/28/2014	11	818	821	-3	-0.004511401
661	5/28/2014	12	691	704	-13	-0.020016519
662	5/28/2014	13	689	666	23	0.033301891
663	5/28/2014	14	732	719	13	0.017110679
664	5/28/2014	15	736	732	4	0.004846989
665	5/28/2014	16	752	757	-5	-0.007347831
666	5/28/2014	17	734	697	37	0.049146049
667	5/28/2014	18	498	558	-60	-0.12128453
668	5/28/2014	19	347	312	35	0.099128357
669	5/28/2014	20	188	167	21	0.107309782
670	5/28/2014	21	98	91	7	0.069608143
671	5/28/2014	22	57	44	13	0.211719189
672	5/28/2014	23	30	37	-7	-0.265381268
673	5/29/2014	0	61	58	3	0.036583557
674	5/29/2014	1	125	111	14	0.109639945
675	5/29/2014	2	223	224	-1	-0.007643912
676	5/29/2014	3	357	348	9	0.023592278
677	5/29/2014	4	601	560	41	0.06752479
678	5/29/2014	5	857	807	50	0.058091048
679	5/29/2014	6	915	1026	-111	-0.122274592
680	5/29/2014	7	940	889	51	0.053799102
681	5/29/2014	8	873	896	-23	-0.026559487
682	5/29/2014	9	864	945	-81	-0.094708542
683	5/29/2014	10	886	862	24	0.025985568
684	5/29/2014	11	827	830	-3	-0.003674656
685	5/29/2014	12	768	749	19	0.023751834
686	5/29/2014	13	632	746	-114	-0.181277506
687	5/29/2014	14	580	691	-111	-0.191973385
688	5/29/2014	15	776	616	160	0.205836074
689	5/29/2014	16	789	847	-58	-0.073900873
690	5/29/2014	17	779	769	10	0.01173762
691	5/29/2014	18	557	556	1	0.00144777
692	5/29/2014	19	315	338	-23	-0.075709889
693	5/29/2014	20	166	163	3	0.015762673
694	5/29/2014	21	97	81	16	0.161692547
695	5/29/2014	22	48	48	0	-0.001387014
696	5/29/2014	23	39	31	8	0.193681073
697	5/30/2014	0	44	75	-31	-0.709779661
698	5/30/2014	1	134	89	45	0.328903919
699	5/30/2014	2	211	239	-28	-0.137352524
700	5/30/2014	3	313	353	-40	-0.129613508
701	5/30/2014	4	495	531	-36	-0.073878702
702	5/30/2014	5	732	681	51	0.069362846
703	5/30/2014	6	868	879	-11	-0.012862009
704	5/30/2014	7	847	842	5	0.005088153
705	5/30/2014	8	791	847	-56	-0.07107184
706	5/30/2014	9	861	860	1	0.00014548
707	5/30/2014	10	897	886	11	0.011928309
708	5/30/2014	11	839	853	-14	-0.01771523
709	5/30/2014	12	764	749	15	0.01878994
710	5/30/2014	13	668	702	-34	-0.051963873
711	5/30/2014	14	691	678	13	0.018028824
712	5/30/2014	15	609	728	-119	-0.195966632
713	5/30/2014	16	644	690	-46	-0.072215607
714	5/30/2014	17	627	651	-24	-0.039222108
715	5/30/2014	18	499	487	12	0.023286532
716	5/30/2014	19	334	305	29	0.084980687
717	5/30/2014	20	209	171	38	0.177208403
718	5/30/2014	21	92	103	-11	-0.121279488
719	5/30/2014	22	54	47	7	0.117853133
720	5/30/2014	23	32	33	-1	-0.031664682
721	5/31/2014	0	54	58	-4	-0.084052411
722	5/31/2014	1	129	117	12	0.086171185
723	5/31/2014	2	201	220	-19	-0.096135785
724	5/31/2014	3	341	326	15	0.042781415
725	5/31/2014	4	499	553	-54	-0.110149176
726	5/31/2014	5	644	717	-73	-0.114214588
727	5/31/2014	6	859	785	74	0.0859733
728	5/31/2014	7	778	834	-56	-0.072442293
729	5/31/2014	8	771	791	-20	-0.026719331
730	5/31/2014	9	803	848	-45	-0.056793715
731	5/31/2014	10	765	831	-66	-0.086725027
732	5/31/2014	11	752	748	4	0.00482045
733	5/31/2014	12	705	695	10	0.012832682
734	5/31/2014	13	647	662	-15	-0.024687056
735	5/31/2014	14	661	655	6	0.007969218
736	5/31/2014	15	666	692	-26	-0.03962631
737	5/31/2014	16	649	708	-59	-0.091599417
738	5/31/2014	17	580	655	-75	-0.130151072
739	5/31/2014	18	552	451	101	0.182470011
740	5/31/2014	19	317	356	-39	-0.123691073
741	5/31/2014	20	219	179	40	0.180539724
742	5/31/2014	21	94	101	-7	-0.079403643
743	5/31/2014	22	44	48	-4	-0.096296213
744	5/31/2014	23	29	30	-1	-0.066788681
745	6/1/2014	0	36	48	-12	-0.338050993
746	6/1/2014	1	103	96	7	0.06372274
747	6/1/2014	2	165	181	-16	-0.100538585
748	6/1/2014	3	339	278	61	0.178608896
749	6/1/2014	4	440	534	-94	-0.215272165
750	6/1/2014	5	663	619	44	0.06531145
751	6/1/2014	6	762	799	-37	-0.049621943
752	6/1/2014	7	834	731	103	0.122984565
753	6/1/2014	8	759	833	-74	-0.09870545
754	6/1/2014	9	740	817	-77	-0.104701421
755	6/1/2014	10	733	761	-28	-0.038345638
756	6/1/2014	11	693	723	-30	-0.044586056
757	6/1/2014	12	691	657	34	0.047775942
758	6/1/2014	13	731	641	90	0.122479134
759	6/1/2014	14	709	719	-10	-0.015492765
760	6/1/2014	15	675	718	-43	-0.0637807
761	6/1/2014	16	673	681	-8	-0.013181715
762	6/1/2014	17	741	645	96	0.128877979
763	6/1/2014	18	531	576	-45	-0.086353488
764	6/1/2014	19	348	332	16	0.045759526
765	6/1/2014	20	197	203	-6	-0.032794983
766	6/1/2014	21	86	95	-9	-0.114534317
767	6/1/2014	22	43	47	-4	-0.113187413
768	6/1/2014	23	43	28	15	0.343645198
769	6/2/2014	0	55	60	-5	-0.106603195
770	6/2/2014	1	100	138	-38	-0.38525202
771	6/2/2014	2	206	166	40	0.192398869
772	6/2/2014	3	337	347	-10	-0.029753958
773	6/2/2014	4	450	527	-77	-0.171994476
774	6/2/2014	5	663	662	1	0.000980172
775	6/2/2014	6	904	790	114	0.125692075
776	6/2/2014	7	842	914	-72	-0.086612114
777	6/2/2014	8	840	811	29	0.034448617
778	6/2/2014	9	938	848	90	0.095302636
779	6/2/2014	10	964	901	63	0.065075666
780	6/2/2014	11	987	893	94	0.094871103
781	6/2/2014	12	847	892	-45	-0.053719353
782	6/2/2014	13	785	747	38	0.048150112
783	6/2/2014	14	804	756	48	0.058460915
784	6/2/2014	15	861	809	52	0.059977899
785	6/2/2014	16	814	836	-22	-0.027736081
786	6/2/2014	17	798	774	24	0.029717417
787	6/2/2014	18	552	631	-79	-0.143144234
788	6/2/2014	19	312	350	-38	-0.121840971
789	6/2/2014	20	153	191	-38	-0.251949447
790	6/2/2014	21	89	78	11	0.122758661
791	6/2/2014	22	50	47	3	0.044764736
792	6/2/2014	23	30	38	-8	-0.282076927
793	6/3/2014	0	44	41	3	0.06583218
794	6/3/2014	1	114	110	4	0.031727754
795	6/3/2014	2	237	195	42	0.176602236
796	6/3/2014	3	342	391	-49	-0.144915472
797	6/3/2014	4	509	479	30	0.057281485
798	6/3/2014	5	742	717	25	0.03319508
799	6/3/2014	6	856	929	-73	-0.085517138
800	6/3/2014	7	957	851	106	0.11006151
801	6/3/2014	8	918	883	35	0.037081949
802	6/3/2014	9	981	951	30	0.029566105
803	6/3/2014	10	1014	973	41	0.04017533
804	6/3/2014	11	925	940	-15	-0.017244728
805	6/3/2014	12	879	835	44	0.049069362
806	6/3/2014	13	836	817	19	0.021738663
807	6/3/2014	14	780	827	-47	-0.061512992
808	6/3/2014	15	779	751	28	0.034674659
809	6/3/2014	16	746	770	-24	-0.032974289
810	6/3/2014	17	781	750	31	0.038486928
811	6/3/2014	18	625	588	37	0.057955441
812	6/3/2014	19	308	369	-61	-0.199080143
813	6/3/2014	20	151	188	-37	-0.245840271
814	6/3/2014	21	78	76	2	0.021584998
815	6/3/2014	22	52	43	9	0.165699479
816	6/3/2014	23	53	37	16	0.297123295
817	6/4/2014	0	57	67	-10	-0.186217506
818	6/4/2014	1	109	124	-15	-0.144208026
819	6/4/2014	2	291	196	95	0.326155988
820	6/4/2014	3	405	463	-58	-0.144045065
821	6/4/2014	4	569	562	7	0.010581911
822	6/4/2014	5	769	774	-5	-0.007048861
823	6/4/2014	6	908	940	-32	-0.035774239
824	6/4/2014	7	887	944	-57	-0.064820535
825	6/4/2014	8	965	875	90	0.092576782
826	6/4/2014	9	994	1002	-8	-0.008300259
827	6/4/2014	10	1010	977	33	0.031993904
828	6/4/2014	11	889	959	-70	-0.079664778
829	6/4/2014	12	849	825	24	0.027887112
830	6/4/2014	13	777	813	-36	-0.046814161
831	6/4/2014	14	854	782	72	0.084240951
832	6/4/2014	15	801	850	-49	-0.062051571
833	6/4/2014	16	959	770	189	0.196741503
834	6/4/2014	17	870	910	-40	-0.046756116
835	6/4/2014	18	664	675	-11	-0.016614757
836	6/4/2014	19	346	369	-23	-0.066944959
837	6/4/2014	20	205	183	22	0.103404346
838	6/4/2014	21	92	100	-8	-0.097043763
839	6/4/2014	22	71	51	20	0.267932397
840	6/4/2014	23	46	52	-6	-0.140040568
841	6/5/2014	0	56	56	0	-0.007519617
842	6/5/2014	1	142	122	20	0.134771594
843	6/5/2014	2	260	273	-13	-0.052304792
844	6/5/2014	3	382	417	-35	-0.092363585
845	6/5/2014	4	555	536	19	0.033926374
846	6/5/2014	5	785	799	-14	-0.018527126
847	6/5/2014	6	959	960	-1	-0.001618033
848	6/5/2014	7	1006	979	27	0.026252392
849	6/5/2014	8	979	973	6	0.005430433
850	6/5/2014	9	951	1026	-75	-0.079545429
851	6/5/2014	10	1019	979	40	0.0382827
852	6/5/2014	11	1001	946	55	0.054939474
853	6/5/2014	12	869	930	-61	-0.071027835
854	6/5/2014	13	740	840	-100	-0.135436165
855	6/5/2014	14	806	758	48	0.059530596
856	6/5/2014	15	789	817	-28	-0.036066132
857	6/5/2014	16	846	826	20	0.022623309
858	6/5/2014	17	829	859	-30	-0.036764285
859	6/5/2014	18	671	607	64	0.093974919
860	6/5/2014	19	365	359	6	0.015289516
861	6/5/2014	20	169	195	-26	-0.157394531
862	6/5/2014	21	95	85	10	0.105162886
863	6/5/2014	22	43	57	-14	-0.332993483
864	6/5/2014	23	52	36	16	0.288503727
865	6/6/2014	0	73	63	10	0.136414237
866	6/6/2014	1	130	148	-18	-0.144807903
867	6/6/2014	2	259	277	-18	-0.071712207
868	6/6/2014	3	382	371	11	0.027858812
869	6/6/2014	4	554	544	10	0.016997752
870	6/6/2014	5	821	802	19	0.022369036
871	6/6/2014	6	912	1002	-90	-0.098740262
872	6/6/2014	7	899	938	-39	-0.043397599
873	6/6/2014	8	879	921	-42	-0.048907827
874	6/6/2014	9	908	943	-35	-0.038835939
875	6/6/2014	10	935	967	-32	-0.035130665
876	6/6/2014	11	921	915	6	0.005583403
877	6/6/2014	12	816	853	-37	-0.046322562
878	6/6/2014	13	722	756	-34	-0.047818101
879	6/6/2014	14	716	767	-51	-0.071744514
880	6/6/2014	15	778	729	49	0.061784304
881	6/6/2014	16	793	838	-45	-0.057288423
882	6/6/2014	17	733	780	-47	-0.065106882
883	6/6/2014	18	568	582	-14	-0.025162669
884	6/6/2014	19	360	314	46	0.126389447
885	6/6/2014	20	214	179	35	0.159098043
886	6/6/2014	21	86	104	-18	-0.21930585
887	6/6/2014	22	62	52	10	0.150873117
888	6/6/2014	23	44	49	-5	-0.124623549
889	6/7/2014	0	45	57	-12	-0.276520011
890	6/7/2014	1	99	106	-7	-0.078081037
891	6/7/2014	2	239	217	22	0.090856782
892	6/7/2014	3	376	364	12	0.029850461
893	6/7/2014	4	604	563	41	0.066288335
894	6/7/2014	5	733	835	-102	-0.139707045
895	6/7/2014	6	821	857	-36	-0.043887954
896	6/7/2014	7	932	861	71	0.075566242
897	6/7/2014	8	916	933	-17	-0.019637611
898	6/7/2014	9	803	952	-149	-0.185858115
899	6/7/2014	10	890	876	14	0.014952244
900	6/7/2014	11	875	863	12	0.013171557
901	6/7/2014	12	799	824	-25	-0.032171246
902	6/7/2014	13	770	732	38	0.048427481
903	6/7/2014	14	697	788	-91	-0.130584318
904	6/7/2014	15	718	729	-11	-0.016115214
905	6/7/2014	16	750	767	-17	-0.023683266
906	6/7/2014	17	689	752	-63	-0.092349594
907	6/7/2014	18	570	568	2	0.002355501
908	6/7/2014	19	381	316	65	0.170156389
909	6/7/2014	20	184	200	-16	-0.08863114
910	6/7/2014	21	103	89	14	0.128273061
911	6/7/2014	22	75	61	14	0.185163773
912	6/7/2014	23	26	60	-34	-1.329591777
913	6/8/2014	0	47	35	12	0.245058639
914	6/8/2014	1	111	100	11	0.096266332
915	6/8/2014	2	190	269	-79	-0.418212269
916	6/8/2014	3	355	318	37	0.102868875
917	6/8/2014	4	543	505	38	0.069244474
918	6/8/2014	5	657	759	-102	-0.155577262
919	6/8/2014	6	928	793	135	0.14459136
920	6/8/2014	7	881	923	-42	-0.048210768
921	6/8/2014	8	858	902	-44	-0.051554374
922	6/8/2014	9	788	861	-73	-0.093416733
923	6/8/2014	10	776	850	-74	-0.095364545
924	6/8/2014	11	788	786	2	0.002275252
925	6/8/2014	12	780	753	27	0.033684944
926	6/8/2014	13	705	724	-19	-0.02767611
927	6/8/2014	14	746	729	17	0.022161195
928	6/8/2014	15	835	740	95	0.113295856
929	6/8/2014	16	781	882	-101	-0.129649879
930	6/8/2014	17	802	750	52	0.064276325
931	6/8/2014	18	641	613	28	0.04231345
932	6/8/2014	19	366	378	-12	-0.034565047
933	6/8/2014	20	200	200	0	-0.001442853
934	6/8/2014	21	108	94	14	0.123781937
935	6/8/2014	22	49	68	-19	-0.398063685
936	6/8/2014	23	42	34	8	0.167119485
937	6/9/2014	0	53	54	-1	-0.032869755
938	6/9/2014	1	108	120	-12	-0.11476744
939	6/9/2014	2	233	225	8	0.033781424
940	6/9/2014	3	389	362	27	0.067227855
941	6/9/2014	4	550	594	-44	-0.080986239
942	6/9/2014	5	843	737	106	0.125682293
943	6/9/2014	6	853	979	-126	-0.14776328
944	6/9/2014	7	1024	904	120	0.11633034
945	6/9/2014	8	1006	986	20	0.01935825
946	6/9/2014	9	1079	925	154	0.142710608
947	6/9/2014	10	1127	1093	34	0.029459117
948	6/9/2014	11	1018	1065	-47	-0.046728081
949	6/9/2014	12	949	904	45	0.046848445
950	6/9/2014	13	937	838	99	0.10491645
951	6/9/2014	14	858	911	-53	-0.061879803
952	6/9/2014	15	887	893	-6	-0.0074733
953	6/9/2014	16	949	892	57	0.059674398
954	6/9/2014	17	941	876	65	0.068203996
955	6/9/2014	18	677	749	-72	-0.106566994
956	6/9/2014	19	309	410	-101	-0.327852782
957	6/9/2014	20	166	166	0	-0.002649055
958	6/9/2014	21	81	91	-10	-0.126177413
959	6/9/2014	22	54	52	2	0.035044089
960	6/9/2014	23	46	38	8	0.171249842
961	6/10/2014	0	53	61	-8	-0.157195124
962	6/10/2014	1	118	112	6	0.047429566
963	6/10/2014	2	253	232	21	0.0826383
964	6/10/2014	3	409	414	-5	-0.012242379
965	6/10/2014	4	593	615	-22	-0.038092839
966	6/10/2014	5	847	789	58	0.067612683
967	6/10/2014	6	939	978	-39	-0.041907363
968	6/10/2014	7	956	998	-42	-0.044196055
969	6/10/2014	8	1021	949	72	0.069962336
970	6/10/2014	9	951	993	-42	-0.045180803
971	6/10/2014	10	1032	987	45	0.043309142
972	6/10/2014	11	1035	986	49	0.047196831
973	6/10/2014	12	885	944	-59	-0.067123971
974	6/10/2014	13	832	825	7	0.008203745
975	6/10/2014	14	792	798	-6	-0.008245207
976	6/10/2014	15	821	851	-30	-0.037536177
977	6/10/2014	16	876	837	39	0.043586518
978	6/10/2014	17	912	852	60	0.064917131
979	6/10/2014	18	612	695	-83	-0.137153438
980	6/10/2014	19	363	350	13	0.033388749
981	6/10/2014	20	164	195	-31	-0.191577568
982	6/10/2014	21	115	85	30	0.254108595
983	6/10/2014	22	63	70	-7	-0.112642056
984	6/10/2014	23	43	41	2	0.025192908
985	6/11/2014	0	75	53	22	0.285278502
986	6/11/2014	1	120	148	-28	-0.237281697
987	6/11/2014	2	286	249	37	0.12697799
988	6/11/2014	3	398	450	-52	-0.131951914
989	6/11/2014	4	575	599	-24	-0.042759232
990	6/11/2014	5	783	803	-20	-0.025749457
991	6/11/2014	6	1011	913	98	0.096765209
992	6/11/2014	7	1123	1090	33	0.028705437
993	6/11/2014	8	954	1092	-138	-0.145613141
994	6/11/2014	9	1013	911	102	0.100407188
995	6/11/2014	10	1075	1048	27	0.024501983
996	6/11/2014	11	1057	1040	17	0.015825073
997	6/11/2014	12	974	965	9	0.008702453
998	6/11/2014	13	796	897	-101	-0.127027108
999	6/11/2014	14	837	778	59	0.069307843
1000	6/11/2014	15	846	879	-33	-0.039402584
1001	6/11/2014	16	828	900	-72	-0.087137973
1002	6/11/2014	17	892	838	54	0.060201473
1003	6/11/2014	18	661	664	-3	-0.004636416
1004	6/11/2014	19	360	381	-21	-0.059512782
1005	6/11/2014	20	227	181	46	0.198932479
1006	6/11/2014	21	100	122	-22	-0.224125831
1007	6/11/2014	22	58	60	-2	-0.038970697
1008	6/11/2014	23	50	38	12	0.23106975
1009	6/12/2014	0	58	69	-11	-0.190077018
1010	6/12/2014	1	144	122	22	0.151740273
1011	6/12/2014	2	286	285	1	0.000600546
1012	6/12/2014	3	378	445	-67	-0.17926276
1013	6/12/2014	4	592	569	23	0.038562941
1014	6/12/2014	5	883	816	67	0.074789434
1015	6/12/2014	6	953	1065	-112	-0.117664857
1016	6/12/2014	7	1010	1035	-25	-0.025664243
1017	6/12/2014	8	959	979	-20	-0.021146795
1018	6/12/2014	9	1115	966	149	0.133269883
1019	6/12/2014	10	1027	1152	-125	-0.122114263
1020	6/12/2014	11	1027	1010	17	0.016198459
1021	6/12/2014	12	957	930	27	0.027691141
1022	6/12/2014	13	861	875	-14	-0.017048512
1023	6/12/2014	14	805	853	-48	-0.059700849
1024	6/12/2014	15	889	856	33	0.036515572
1025	6/12/2014	16	902	898	4	0.003408396
1026	6/12/2014	17	911	935	-24	-0.026374403
1027	6/12/2014	18	625	676	-51	-0.081712629
1028	6/12/2014	19	365	339	26	0.069867363
1029	6/12/2014	20	158	196	-38	-0.240783868
1030	6/12/2014	21	91	90	1	0.003188271
1031	6/12/2014	22	39	52	-13	-0.338839885
1032	6/12/2014	23	31	34	-3	-0.108916681
1033	6/13/2014	0	52	46	6	0.101479448
1034	6/13/2014	1	110	111	-1	-0.015013654
1035	6/13/2014	2	164	246	-82	-0.50042353
1036	6/13/2014	3	277	268	9	0.029336969
1037	6/13/2014	4	470	434	36	0.075291348
1038	6/13/2014	5	638	730	-92	-0.144562612
1039	6/13/2014	6	798	769	29	0.035615441
1040	6/13/2014	7	1024	879	145	0.141451902
1041	6/13/2014	8	952	971	-19	-0.020932505
1042	6/13/2014	9	871	1007	-136	-0.156909653
1043	6/13/2014	10	1014	903	111	0.108763614
1044	6/13/2014	11	907	986	-79	-0.087990601
1045	6/13/2014	12	876	866	10	0.011329417
1046	6/13/2014	13	784	800	-16	-0.020455387
1047	6/13/2014	14	755	772	-17	-0.022550009
1048	6/13/2014	15	772	803	-31	-0.041281001
1049	6/13/2014	16	774	818	-44	-0.05750683
1050	6/13/2014	17	800	821	-21	-0.027239644
1051	6/13/2014	18	585	571	14	0.023387846
1052	6/13/2014	19	365	328	37	0.100793132
1053	6/13/2014	20	199	186	13	0.065042034
1054	6/13/2014	21	90	101	-11	-0.127899716
1055	6/13/2014	22	50	49	1	0.019924498
1056	6/13/2014	23	54	40	14	0.246585371
1057	6/14/2014	0	47	71	-24	-0.512640925
1058	6/14/2014	1	114	104	10	0.085834805
1059	6/14/2014	2	236	227	9	0.035689307
1060	6/14/2014	3	363	359	4	0.009304276
1061	6/14/2014	4	552	569	-17	-0.031287517
1062	6/14/2014	5	717	778	-61	-0.085270058
1063	6/14/2014	6	961	868	93	0.096030509
1064	6/14/2014	7	1027	1073	-46	-0.045578943
1065	6/14/2014	8	977	981	-4	-0.004612421
1066	6/14/2014	9	906	987	-81	-0.090150329
1067	6/14/2014	10	911	973	-62	-0.068074071
1068	6/14/2014	11	950	930	20	0.020566909
1069	6/14/2014	12	870	896	-26	-0.030838066
1070	6/14/2014	13	727	798	-71	-0.097848994
1071	6/14/2014	14	807	732	75	0.092218758
1072	6/14/2014	15	788	853	-65	-0.082709304
1073	6/14/2014	16	834	811	23	0.026884643
1074	6/14/2014	17	854	865	-11	-0.013801087
1075	6/14/2014	18	632	629	3	0.004688179
1076	6/14/2014	19	382	370	12	0.030058492
1077	6/14/2014	20	238	190	48	0.199497968
1078	6/14/2014	21	149	122	27	0.175959858
1079	6/14/2014	22	56	71	-15	-0.272675733
1080	6/14/2014	23	39	45	-6	-0.158253449
1081	6/15/2014	0	52	52	0	-0.013631997
1082	6/15/2014	1	87	118	-31	-0.357640331
1083	6/15/2014	2	189	189	0	-0.001692265
1084	6/15/2014	3	372	305	67	0.177620017
1085	6/15/2014	4	533	591	-58	-0.109175955
1086	6/15/2014	5	705	742	-37	-0.053313001
1087	6/15/2014	6	926	857	69	0.073780184
1088	6/15/2014	7	984	1037	-53	-0.054087997
1089	6/15/2014	8	937	931	6	0.00559361
1090	6/15/2014	9	822	954	-132	-0.161776238
1091	6/15/2014	10	892	887	5	0.005423196
1092	6/15/2014	11	783	901	-118	-0.151629406
1093	6/15/2014	12	811	788	23	0.027890348
1094	6/15/2014	13	836	730	106	0.126210629
1095	6/15/2014	14	915	836	79	0.086214941
1096	6/15/2014	15	882	910	-28	-0.032409778
1097	6/15/2014	16	953	877	76	0.079265406
1098	6/15/2014	17	904	943	-39	-0.043303045
1099	6/15/2014	18	629	634	-5	-0.009249029
1100	6/15/2014	19	341	378	-37	-0.111346631
1101	6/15/2014	20	170	195	-25	-0.148527797
1102	6/15/2014	21	89	91	-2	-0.030220738
1103	6/15/2014	22	52	45	7	0.129249461
1104	6/15/2014	23	32	45	-13	-0.412083741
1105	6/16/2014	0	54	40	14	0.245199821
1106	6/16/2014	1	114	114	0	-0.002634108
1107	6/16/2014	2	251	223	28	0.108652522
1108	6/16/2014	3	375	388	-13	-0.03708943
1109	6/16/2014	4	644	553	91	0.140238512
1110	6/16/2014	5	905	842	63	0.068795277
1111	6/16/2014	6	1058	1071	-13	-0.012599842
1112	6/16/2014	7	1079	1144	-65	-0.060904149
1113	6/16/2014	8	977	1011	-34	-0.035415842
1114	6/16/2014	9	1137	959	178	0.156318337
1115	6/16/2014	10	1054	1160	-106	-0.100609841
1116	6/16/2014	11	1093	1003	90	0.081666697
1117	6/16/2014	12	1052	1012	40	0.037076638
1118	6/16/2014	13	873	931	-58	-0.066590363
1119	6/16/2014	14	876	903	-27	-0.0310663
1120	6/16/2014	15	900	878	22	0.024101035
1121	6/16/2014	16	913	924	-11	-0.012358263
1122	6/16/2014	17	838	937	-99	-0.119042835
1123	6/16/2014	18	649	617	32	0.048081828
1124	6/16/2014	19	401	380	21	0.051342377
1125	6/16/2014	20	238	210	28	0.113450993
1126	6/16/2014	21	85	126	-41	-0.493472144
1127	6/16/2014	22	66	41	25	0.363972181
1128	6/16/2014	23	31	48	-17	-0.560210599
1129	6/17/2014	0	58	46	12	0.202037934
1130	6/17/2014	1	154	116	38	0.243127194
1131	6/17/2014	2	246	280	-34	-0.140168275
1132	6/17/2014	3	389	407	-18	-0.048103317
1133	6/17/2014	4	699	590	109	0.155370772
1134	6/17/2014	5	861	903	-42	-0.049573924
1135	6/17/2014	6	1048	1100	-52	-0.050314884
1136	6/17/2014	7	1123	1140	-17	-0.015762138
1137	6/17/2014	8	962	1045	-83	-0.086282215
1138	6/17/2014	9	1072	953	119	0.110543923
1139	6/17/2014	10	1077	1117	-40	-0.038012065
1140	6/17/2014	11	1018	1029	-11	-0.010962588
1141	6/17/2014	12	943	971	-28	-0.03027927
1142	6/17/2014	13	850	846	4	0.004268601
1143	6/17/2014	14	814	888	-74	-0.091388895
1144	6/17/2014	15	1002	839	163	0.161767591
1145	6/17/2014	16	1047	1016	31	0.029505083
1146	6/17/2014	17	988	1007	-19	-0.020233245
1147	6/17/2014	18	727	697	30	0.040709308
1148	6/17/2014	19	442	417	25	0.055627754
1149	6/17/2014	20	197	245	-48	-0.248181445
1150	6/17/2014	21	109	96	13	0.110279335
1151	6/17/2014	22	63	59	4	0.050481164
1152	6/17/2014	23	48	42	6	0.107555238
1153	6/18/2014	0	59	65	-6	-0.108558285
1154	6/18/2014	1	137	124	13	0.091230526
1155	6/18/2014	2	267	268	-1	-0.005513142
1156	6/18/2014	3	462	426	36	0.07791213
1157	6/18/2014	4	652	716	-64	-0.099038888
1158	6/18/2014	5	952	857	95	0.099756171
1159	6/18/2014	6	1060	1166	-106	-0.100883864
1160	6/18/2014	7	1121	1124	-3	-0.003491493
1161	6/18/2014	8	975	1035	-60	-0.062303352
1162	6/18/2014	9	1107	1007	100	0.089760917
1163	6/18/2014	10	1048	1106	-58	-0.056034035
1164	6/18/2014	11	1047	1032	15	0.013943809
1165	6/18/2014	12	975	992	-17	-0.017545877
1166	6/18/2014	13	864	866	-2	-0.002716725
1167	6/18/2014	14	925	915	10	0.01030645
1168	6/18/2014	15	916	956	-40	-0.043814744
1169	6/18/2014	16	960	972	-12	-0.01261727
1170	6/18/2014	17	887	926	-39	-0.044489059
1171	6/18/2014	18	750	671	79	0.10472205
1172	6/18/2014	19	397	436	-39	-0.099807672
1173	6/18/2014	20	191	213	-22	-0.119148986
1174	6/18/2014	21	117	98	19	0.159133268
1175	6/18/2014	22	72	66	6	0.073196488
1176	6/18/2014	23	37	43	-6	-0.184732407
1177	6/19/2014	0	51	56	-5	-0.09972142
1178	6/19/2014	1	134	113	21	0.153311263
1179	6/19/2014	2	234	259	-25	-0.110569039
1180	6/19/2014	3	390	407	-17	-0.04552708
1181	6/19/2014	4	592	631	-39	-0.066419691
1182	6/19/2014	5	875	815	60	0.068399559
1183	6/19/2014	6	1023	1070	-47	-0.046724811
1184	6/19/2014	7	1048	1092	-44	-0.042098789
1185	6/19/2014	8	1017	939	78	0.076414688
1186	6/19/2014	9	1002	1088	-86	-0.086235265
1187	6/19/2014	10	1046	1014	32	0.030062018
1188	6/19/2014	11	1086	998	88	0.080327454
1189	6/19/2014	12	987	1022	-35	-0.036276984
1190	6/19/2014	13	884	906	-22	-0.02519373
1191	6/19/2014	14	902	894	8	0.008300825
1192	6/19/2014	15	871	952	-81	-0.093029953
1193	6/19/2014	16	963	940	23	0.023367662
1194	6/19/2014	17	901	920	-19	-0.021685888
1195	6/19/2014	18	705	692	13	0.018179488
1196	6/19/2014	19	372	405	-33	-0.089849479
1197	6/19/2014	20	197	191	6	0.025667898
1198	6/19/2014	21	108	99	9	0.075650351
1199	6/19/2014	22	55	67	-12	-0.219536257
1200	6/19/2014	23	33	33	0	-0.015319131
1201	6/20/2014	0	66	51	15	0.227038896
1202	6/20/2014	1	141	155	-14	-0.103820806
1203	6/20/2014	2	257	265	-8	-0.032906921
1204	6/20/2014	3	385	408	-23	-0.060691232
1205	6/20/2014	4	615	615	0	-0.000986843
1206	6/20/2014	5	739	889	-150	-0.203239966
1207	6/20/2014	6	945	914	31	0.032505625
1208	6/20/2014	7	974	1024	-50	-0.051709358
1209	6/20/2014	8	854	920	-66	-0.077563064
1210	6/20/2014	9	857	980	-123	-0.14407447
1211	6/20/2014	10	967	879	88	0.090828525
1212	6/20/2014	11	861	1003	-142	-0.165767646
1213	6/20/2014	12	977	858	119	0.121655327
1214	6/20/2014	13	818	853	-35	-0.043365951
1215	6/20/2014	14	867	837	30	0.034137122
1216	6/20/2014	15	861	910	-49	-0.05727299
1217	6/20/2014	16	983	920	63	0.063175329
1218	6/20/2014	17	850	908	-58	-0.068382748
1219	6/20/2014	18	667	679	-12	-0.018471378
1220	6/20/2014	19	369	389	-20	-0.056904338
1221	6/20/2014	20	199	191	8	0.040085793
1222	6/20/2014	21	119	103	16	0.129859054
1223	6/20/2014	22	68	71	-3	-0.051741365
1224	6/20/2014	23	50	38	12	0.224895702
1225	6/21/2014	0	54	72	-18	-0.341406997
1226	6/21/2014	1	113	134	-21	-0.18891054
1227	6/21/2014	2	260	210	50	0.189002662
1228	6/21/2014	3	422	422	0	-0.000991268
1229	6/21/2014	4	632	685	-53	-0.08540075
1230	6/21/2014	5	927	847	80	0.086184893
1231	6/21/2014	6	1062	1073	-11	-0.011035776
1232	6/21/2014	7	1101	1120	-19	-0.017302011
1233	6/21/2014	8	1052	981	71	0.06744222
1234	6/21/2014	9	1000	1079	-79	-0.07956443
1235	6/21/2014	10	948	1042	-94	-0.099786815
1236	6/21/2014	11	874	951	-77	-0.088190701
1237	6/21/2014	12	842	883	-41	-0.049759455
1238	6/21/2014	13	859	787	72	0.08351854
1239	6/21/2014	14	850	904	-54	-0.063832568
1240	6/21/2014	15	879	892	-13	-0.015329348
1241	6/21/2014	16	904	958	-54	-0.060285619
1242	6/21/2014	17	772	848	-76	-0.098652829
1243	6/21/2014	18	676	644	32	0.046630111
1244	6/21/2014	19	397	378	19	0.047449044
1245	6/21/2014	20	184	199	-15	-0.085662155
1246	6/21/2014	21	109	109	0	-0.001762155
1247	6/21/2014	22	53	62	-9	-0.178340603
1248	6/21/2014	23	37	35	2	0.04013465
1249	6/22/2014	0	48	53	-5	-0.118960278
1250	6/22/2014	1	116	115	1	0.00416349
1251	6/22/2014	2	235	232	3	0.010039878
1252	6/22/2014	3	389	396	-7	-0.019004982
1253	6/22/2014	4	592	604	-12	-0.02191967
1254	6/22/2014	5	917	820	97	0.105441849
1255	6/22/2014	6	1089	1062	27	0.024607662
1256	6/22/2014	7	1003	1108	-105	-0.10483502
1257	6/22/2014	8	910	927	-17	-0.019462142
1258	6/22/2014	9	841	940	-99	-0.117890675
1259	6/22/2014	10	911	901	10	0.010411475
1260	6/22/2014	11	848	899	-51	-0.060794749
1261	6/22/2014	12	934	871	63	0.066797142
1262	6/22/2014	13	1081	855	226	0.208176281
1263	6/22/2014	14	1094	1063	31	0.028176932
1264	6/22/2014	15	1047	1030	17	0.016135886
1265	6/22/2014	16	1174	1058	116	0.098540138
1266	6/22/2014	17	1099	986	113	0.102038425
1267	6/22/2014	18	696	859	-163	-0.234692472
1268	6/22/2014	19	434	388	46	0.104138961
1269	6/22/2014	20	221	215	6	0.02426243
1270	6/22/2014	21	103	129	-26	-0.252653481
1271	6/22/2014	22	58	58	0	-0.004555456
1272	6/22/2014	23	36	37	-1	-0.046290651
1273	6/23/2014	0	60	52	8	0.1202962
1274	6/23/2014	1	135	139	-4	-0.035529546
1275	6/23/2014	2	260	263	-3	-0.011847709
1276	6/23/2014	3	400	408	-8	-0.020420241
1277	6/23/2014	4	657	609	48	0.071935326
1278	6/23/2014	5	998	940	58	0.057743909
1279	6/23/2014	6	1165	1165	0	-0.000299558
1280	6/23/2014	7	1157	1148	9	0.007396386
1281	6/23/2014	8	1297	1055	242	0.185886447
1282	6/23/2014	9	1255	1183	72	0.05709305
1283	6/23/2014	10	1210	1241	-31	-0.0258813
1284	6/23/2014	11	1242	1093	149	0.119655013
1285	6/23/2014	12	1115	1210	-95	-0.085493889
1286	6/23/2014	13	1009	1067	-58	-0.057972031
1287	6/23/2014	14	976	1025	-49	-0.050545952
1288	6/23/2014	15	1080	988	92	0.084548737
1289	6/23/2014	16	1008	1183	-175	-0.174396274
1290	6/23/2014	17	1044	927	117	0.111205435
1291	6/23/2014	18	770	789	-19	-0.025734146
1292	6/23/2014	19	376	440	-64	-0.171745144
1293	6/23/2014	20	201	196	5	0.02418492
1294	6/23/2014	21	109	111	-2	-0.027317798
1295	6/23/2014	22	67	59	8	0.111170172
1296	6/23/2014	23	49	44	5	0.1014656
1297	6/24/2014	0	69	68	1	0.003675548
1298	6/24/2014	1	151	146	5	0.027824858
1299	6/24/2014	2	271	290	-19	-0.073787161
1300	6/24/2014	3	403	431	-28	-0.071949828
1301	6/24/2014	4	735	647	88	0.119429577
1302	6/24/2014	5	977	1039	-62	-0.063847285
1303	6/24/2014	6	1124	1188	-64	-0.057488227
1304	6/24/2014	7	1143	1118	25	0.021479192
1305	6/24/2014	8	1195	1089	106	0.088518881
1306	6/24/2014	9	1176	1132	44	0.037056089
1307	6/24/2014	10	1120	1186	-66	-0.059801469
1308	6/24/2014	11	1142	1020	122	0.106369863
1309	6/24/2014	12	1045	1113	-68	-0.065156823
1310	6/24/2014	13	919	1034	-115	-0.125987825
1311	6/24/2014	14	951	939	12	0.011883937
1312	6/24/2014	15	990	981	9	0.009010675
1313	6/24/2014	16	1056	1079	-23	-0.021789547
1314	6/24/2014	17	1040	985	55	0.052328031
1315	6/24/2014	18	820	761	59	0.071728195
1316	6/24/2014	19	456	449	7	0.01358676
1317	6/24/2014	20	227	226	1	0.001280207
1318	6/24/2014	21	112	120	-8	-0.072115266
1319	6/24/2014	22	67	63	4	0.059457114
1320	6/24/2014	23	53	46	7	0.120707722
1321	6/25/2014	0	81	70	11	0.134533165
1322	6/25/2014	1	137	168	-31	-0.232025997
1323	6/25/2014	2	285	267	18	0.059910353
1324	6/25/2014	3	445	438	7	0.013529079
1325	6/25/2014	4	719	728	-9	-0.012842654
1326	6/25/2014	5	939	1066	-127	-0.136302221
1327	6/25/2014	6	1128	1105	23	0.019683506
1328	6/25/2014	7	1156	1134	22	0.018212117
1329	6/25/2014	8	1059	1185	-126	-0.119181204
1330	6/25/2014	9	1259	1044	215	0.170171421
1331	6/25/2014	10	1167	1198	-31	-0.026863327
1332	6/25/2014	11	1166	1138	28	0.023665708
1333	6/25/2014	12	1111	1100	11	0.009880927
1334	6/25/2014	13	998	1054	-56	-0.056793343
1335	6/25/2014	14	1060	1012	48	0.044441922
1336	6/25/2014	15	1065	1101	-36	-0.034113519
1337	6/25/2014	16	1138	1104	34	0.029048201
1338	6/25/2014	17	1102	1079	23	0.020148093
1339	6/25/2014	18	867	826	41	0.047169297
1340	6/25/2014	19	517	478	39	0.074240366
1341	6/25/2014	20	260	247	13	0.04900385
1342	6/25/2014	21	131	130	1	0.007048942
1343	6/25/2014	22	77	71	6	0.065967378
1344	6/25/2014	23	50	52	-2	-0.054552542
1345	6/26/2014	0	89	72	17	0.185855621
1346	6/26/2014	1	181	178	3	0.014803718
1347	6/26/2014	2	326	337	-11	-0.036684769
1348	6/26/2014	3	517	484	33	0.062923538
1349	6/26/2014	4	834	826	8	0.008879389
1350	6/26/2014	5	1102	1166	-64	-0.058941329
1351	6/26/2014	6	1375	1288	87	0.063030867
1352	6/26/2014	7	1283	1330	-47	-0.036684855
1353	6/26/2014	8	1243	1276	-33	-0.027347965
1354	6/26/2014	9	1306	1259	47	0.035823232
1355	6/26/2014	10	1452	1265	187	0.128709595
1356	6/26/2014	11	1373	1389	-16	-0.01201991
1357	6/26/2014	12	1395	1266	129	0.091792447
1358	6/26/2014	13	1312	1256	56	0.042102419
1359	6/26/2014	14	1313	1276	37	0.02787463
1360	6/26/2014	15	1330	1299	31	0.022880592
1361	6/26/2014	16	1392	1346	46	0.032955504
1362	6/26/2014	17	1242	1332	-90	-0.073053829
1363	6/26/2014	18	1063	906	157	0.147660662
1364	6/26/2014	19	600	574	26	0.041743931
1365	6/26/2014	20	322	297	25	0.074882218
1366	6/26/2014	21	169	151	18	0.102481978
1367	6/26/2014	22	96	92	4	0.039347721
1368	6/26/2014	23	54	63	-9	-0.176089528
1369	6/27/2014	0	91	84	7	0.066679034
1370	6/27/2014	1	183	180	3	0.013762853
1371	6/27/2014	2	322	350	-28	-0.087002808
1372	6/27/2014	3	422	502	-80	-0.191856366
1373	6/27/2014	4	861	722	139	0.161103602
1374	6/27/2014	5	1131	1179	-48	-0.042663766
1375	6/27/2014	6	1289	1366	-77	-0.060209581
1376	6/27/2014	7	1076	1274	-198	-0.184795639
1377	6/27/2014	8	1045	1115	-70	-0.066994788
1378	6/27/2014	9	1148	1168	-20	-0.017434475
1379	6/27/2014	10	1073	1193	-120	-0.112084309
1380	6/27/2014	11	1181	1139	42	0.034750649
1381	6/27/2014	12	1098	1143	-45	-0.041081723
1382	6/27/2014	13	1225	1022	203	0.165531338
1383	6/27/2014	14	1093	1217	-124	-0.114032179
1384	6/27/2014	15	1318	1127	191	0.144823524
1385	6/27/2014	16	1610	1302	308	0.191281301
1386	6/27/2014	17	1645	1454	191	0.115806289
1387	6/27/2014	18	1239	1197	42	0.03335649
1388	6/27/2014	19	722	623	99	0.136386281
1389	6/27/2014	20	406	343	63	0.154935773
1390	6/27/2014	21	181	191	-10	-0.058700548
1391	6/27/2014	22	104	99	5	0.039478199
1392	6/27/2014	23	69	66	3	0.041280438
1393	6/28/2014	0	115	107	8	0.069187805
1394	6/28/2014	1	239	218	21	0.084127441
1395	6/28/2014	2	428	412	16	0.035527637
1396	6/28/2014	3	698	597	101	0.144417884
1397	6/28/2014	4	1063	1137	-74	-0.070485271
1398	6/28/2014	5	1680	1329	351	0.208863619
1399	6/28/2014	6	2009	1818	191	0.095066288
1400	6/28/2014	7	2153	1736	417	0.193482724
1401	6/28/2014	8	1849	1874	-25	-0.013837011
1402	6/28/2014	9	1773	1796	-23	-0.013404201
1403	6/28/2014	10	1761	1649	112	0.063439292
1404	6/28/2014	11	1698	1709	-11	-0.007001814
1405	6/28/2014	12	1417	1598	-181	-0.128237313
1406	6/28/2014	13	1149	1346	-197	-0.17207059
1407	6/28/2014	14	1450	1182	268	0.184282993
1408	6/28/2014	15	1533	1553	-20	-0.013463345
1409	6/28/2014	16	1699	1670	29	0.01665869
1410	6/28/2014	17	1702	1573	129	0.075439965
1411	6/28/2014	18	1222	1287	-65	-0.053913371
1412	6/28/2014	19	782	696	86	0.109169111
1413	6/28/2014	20	449	391	58	0.127194964
1414	6/28/2014	21	170	207	-37	-0.222567914
1415	6/28/2014	22	103	100	3	0.029034245
1416	6/28/2014	23	79	66	13	0.15992478
1417	6/29/2014	0	90	128	-38	-0.425706965
1418	6/29/2014	1	142	186	-44	-0.312809751
1419	6/29/2014	2	367	287	80	0.21687189
1420	6/29/2014	3	512	574	-62	-0.121724681
1421	6/29/2014	4	888	925	-37	-0.041816186
1422	6/29/2014	5	1481	1230	251	0.16908656
1423	6/29/2014	6	1768	1694	74	0.041479987
1424	6/29/2014	7	1824	1672	152	0.082793724
1425	6/29/2014	8	1505	1561	-56	-0.037395478
1426	6/29/2014	9	1473	1548	-75	-0.051362775
1427	6/29/2014	10	1421	1447	-26	-0.018906519
1428	6/29/2014	11	1409	1439	-30	-0.021338101
1429	6/29/2014	12	1304	1333	-29	-0.022473126
1430	6/29/2014	13	1369	1243	126	0.09168709
1431	6/29/2014	14	927	1406	-479	-0.516910264
1432	6/29/2014	15	1065	1076	-11	-0.011176724
1433	6/29/2014	16	1260	1252	8	0.005890984
1434	6/29/2014	17	1428	1293	135	0.094004092
1435	6/29/2014	18	1082	1147	-65	-0.060943374
1436	6/29/2014	19	595	634	-39	-0.066878817
1437	6/29/2014	20	248	321	-73	-0.296433292
1438	6/29/2014	21	130	124	6	0.040288855
1439	6/29/2014	22	86	80	6	0.062287755
1440	6/29/2014	23	51	57	-6	-0.136834758
1441	6/30/2014	0	100	82	18	0.172478683
1442	6/30/2014	1	161	186	-25	-0.159702801
1443	6/30/2014	2	289	319	-30	-0.1043718
1444	6/30/2014	3	515	446	69	0.133253212
1445	6/30/2014	4	735	889	-154	-0.210595535
1446	6/30/2014	5	1074	1146	-72	-0.067738794
1447	6/30/2014	6	1399	1332	67	0.047666589
1448	6/30/2014	7	1561	1378	183	0.116794267
1449	6/30/2014	8	1631	1440	191	0.117069687
1450	6/30/2014	9	1894	1571	323	0.170288424
1451	6/30/2014	10	1866	1716	150	0.079999019
1452	6/30/2014	11	1828	1718	110	0.059891677
1453	6/30/2014	12	1611	1580	31	0.018627993
1454	6/30/2014	13	1393	1468	-75	-0.054552047
1455	6/30/2014	14	1625	1292	333	0.204436365
1456	6/30/2014	15	1570	1681	-111	-0.070760703
1457	6/30/2014	16	1776	1750	26	0.014077097
1458	6/30/2014	17	1946	1783	163	0.083353667
1459	6/30/2014	18	1149	1412	-263	-0.22966578
1460	6/30/2014	19	378	694	-316	-0.837589537
1461	6/30/2014	20	204	228	-24	-0.120029195
1462	6/30/2014	21	82	108	-26	-0.321764509
1463	6/30/2014	22	70	63	7	0.099007581
1464	6/30/2014	23	53	52	1	0.011253352
1465	7/1/2014	0	63	85	-22	-0.360852802
1466	7/1/2014	1	128	122	6	0.044986041
1467	7/1/2014	2	261	267	-6	-0.024385088
1468	7/1/2014	3	414	421	-7	-0.018016749
1469	7/1/2014	4	584	728	-144	-0.247535946
1470	7/1/2014	5	815	959	-144	-0.177016076
1471	7/1/2014	6	997	1101	-104	-0.104984518
1472	7/1/2014	7	1035	1156	-121	-0.117497449
1473	7/1/2014	8	982	1063	-81	-0.082604903
1474	7/1/2014	9	1138	1137	1	0.000441629
1475	7/1/2014	10	964	1185	-221	-0.229888461
1476	7/1/2014	11	993	1050	-57	-0.057494731
1477	7/1/2014	12	943	948	-5	-0.005685017
1478	7/1/2014	13	818	980	-162	-0.198364377
1479	7/1/2014	14	840	856	-16	-0.019476381
1480	7/1/2014	15	948	986	-38	-0.040255193
1481	7/1/2014	16	991	1176	-185	-0.187665454
1482	7/1/2014	17	942	1127	-185	-0.19705261
1483	7/1/2014	18	607	736	-129	-0.214055799
1484	7/1/2014	19	395	347	48	0.120228375
1485	7/1/2014	20	179	217	-38	-0.216407851
1486	7/1/2014	21	101	88	13	0.121350368
1487	7/1/2014	22	49	69	-20	-0.422101138
1488	7/1/2014	23	30	36	-6	-0.217999118
1489	7/2/2014	0	71	50	21	0.292217792
1490	7/2/2014	1	138	130	8	0.053281324
1491	7/2/2014	2	250	283	-33	-0.132668843
1492	7/2/2014	3	389	402	-13	-0.035911728
1493	7/2/2014	4	619	595	24	0.038203631
1494	7/2/2014	5	799	971	-172	-0.215616882
1495	7/2/2014	6	980	1053	-73	-0.074936163
1496	7/2/2014	7	1056	1110	-54	-0.051422002
1497	7/2/2014	8	1006	1060	-54	-0.05439427
1498	7/2/2014	9	1060	1154	-94	-0.089431413
1499	7/2/2014	10	1064	1058	6	0.004702237
1500	7/2/2014	11	1001	1108	-107	-0.106961272
1501	7/2/2014	12	941	959	-18	-0.020058885
1502	7/2/2014	13	906	876	30	0.033055749
1503	7/2/2014	14	845	959	-114	-0.135552983
1504	7/2/2014	15	881	946	-65	-0.073798295
1505	7/2/2014	16	909	1048	-139	-0.15372945
1506	7/2/2014	17	953	1045	-92	-0.097267823
1507	7/2/2014	18	668	690	-22	-0.033435855
1508	7/2/2014	19	353	381	-28	-0.080292193
1509	7/2/2014	20	194	193	1	0.003094285
1510	7/2/2014	21	113	91	22	0.190530562
1511	7/2/2014	22	72	70	2	0.019637516
1512	7/2/2014	23	65	49	16	0.244376355
1513	7/3/2014	0	72	92	-20	-0.287501035
1514	7/3/2014	1	133	130	3	0.018349124
1515	7/3/2014	2	302	275	27	0.088187349
1516	7/3/2014	3	405	470	-65	-0.161252206
1517	7/3/2014	4	602	644	-42	-0.071393457
1518	7/3/2014	5	810	899	-89	-0.110783676
1519	7/3/2014	6	991	1078	-87	-0.088018875
1520	7/3/2014	7	996	1144	-148	-0.148823837
1521	7/3/2014	8	950	1012	-62	-0.065676115
1522	7/3/2014	9	1028	1109	-81	-0.079134177
1523	7/3/2014	10	1082	1044	38	0.034764946
1524	7/3/2014	11	1084	1112	-28	-0.025866898
1525	7/3/2014	12	928	1026	-98	-0.106474242
1526	7/3/2014	13	904	905	-1	-0.001780099
1527	7/3/2014	14	918	873	45	0.048354908
1528	7/3/2014	15	870	1013	-143	-0.165246263
1529	7/3/2014	16	917	997	-80	-0.088277733
1530	7/3/2014	17	934	1004	-70	-0.07574887
1531	7/3/2014	18	634	687	-53	-0.084759314
1532	7/3/2014	19	394	341	53	0.133625888
1533	7/3/2014	20	197	190	7	0.031989936
1534	7/3/2014	21	85	103	-18	-0.223289077
1535	7/3/2014	22	49	57	-8	-0.163496587
1536	7/3/2014	23	54	35	19	0.335891127
1537	7/4/2014	0	73	84	-11	-0.153723656
1538	7/4/2014	1	127	137	-10	-0.080828007
1539	7/4/2014	2	239	242	-3	-0.015189982
1540	7/4/2014	3	390	381	9	0.020768716
1541	7/4/2014	4	621	609	12	0.018196801
1542	7/4/2014	5	707	847	-140	-0.19870165
1543	7/4/2014	6	978	907	71	0.072484747
1544	7/4/2014	7	927	1045	-118	-0.127421495
1545	7/4/2014	8	898	954	-56	-0.062593957
1546	7/4/2014	9	1002	1051	-49	-0.049294197
1547	7/4/2014	10	984	1010	-26	-0.026589596
1548	7/4/2014	11	1059	1022	37	0.034797869
1549	7/4/2014	12	890	984	-94	-0.106112455
1550	7/4/2014	13	769	838	-69	-0.089895912
1551	7/4/2014	14	862	827	35	0.03994723
1552	7/4/2014	15	923	915	8	0.008491246
1553	7/4/2014	16	879	1008	-129	-0.147711554
1554	7/4/2014	17	896	929	-33	-0.037241138
1555	7/4/2014	18	748	612	136	0.18139964
1556	7/4/2014	19	441	393	48	0.107188404
1557	7/4/2014	20	211	219	-8	-0.041642877
1558	7/4/2014	21	121	97	24	0.191805322
1559	7/4/2014	22	72	68	4	0.041736958
1560	7/4/2014	23	54	58	-4	-0.077831502
1561	7/5/2014	0	67	75	-8	-0.120230689
1562	7/5/2014	1	121	128	-7	-0.063151616
1563	7/5/2014	2	266	255	11	0.038362493
1564	7/5/2014	3	429	412	17	0.03785438
1565	7/5/2014	4	629	650	-21	-0.033751706
1566	7/5/2014	5	930	815	115	0.122933591
1567	7/5/2014	6	1052	1140	-88	-0.084488459
1568	7/5/2014	7	1119	1061	58	0.051590338
1569	7/5/2014	8	1071	1039	32	0.029430024
1570	7/5/2014	9	1133	1157	-24	-0.021576119
1571	7/5/2014	10	985	1119	-134	-0.136138729
1572	7/5/2014	11	1033	1014	19	0.018371981
1573	7/5/2014	12	902	932	-30	-0.033852938
1574	7/5/2014	13	833	866	-33	-0.040008498
1575	7/5/2014	14	861	879	-18	-0.021409228
1576	7/5/2014	15	893	901	-8	-0.009318583
1577	7/5/2014	16	908	933	-25	-0.028294978
1578	7/5/2014	17	918	946	-28	-0.030963157
1579	7/5/2014	18	634	662	-28	-0.045027618
1580	7/5/2014	19	461	384	77	0.166994033
1581	7/5/2014	20	238	223	15	0.061473714
1582	7/5/2014	21	140	123	17	0.11827646
1583	7/5/2014	22	68	74	-6	-0.10270872
1584	7/5/2014	23	55	53	2	0.019109482
1585	7/6/2014	0	66	77	-11	-0.180711962
1586	7/6/2014	1	141	125	16	0.112759136
1587	7/6/2014	2	224	288	-64	-0.29003106
1588	7/6/2014	3	411	371	40	0.096797225
1589	7/6/2014	4	563	648	-85	-0.152134046
1590	7/6/2014	5	804	755	49	0.05991038
1591	7/6/2014	6	946	1009	-63	-0.066957945
1592	7/6/2014	7	348	980	-632	-1.818341363
1593	7/6/2014	8	366	432	-66	-0.182975084
1594	7/6/2014	9	678	504	174	0.256016696
1595	7/6/2014	10	1108	788	320	0.288169813
1596	7/6/2014	11	965	1164	-199	-0.2066554
1597	7/6/2014	12	941	801	140	0.148355109
1598	7/6/2014	13	962	794	168	0.17407564
1599	7/6/2014	14	998	935	63	0.062679828
1600	7/6/2014	15	1090	986	104	0.094516884
1601	7/6/2014	16	1073	1011	62	0.057054061
1602	7/6/2014	17	1007	1043	-36	-0.035902306
1603	7/6/2014	18	688	732	-44	-0.064617498
1604	7/6/2014	19	397	422	-25	-0.063607986
1605	7/6/2014	20	228	209	19	0.081661298
1606	7/6/2014	21	103	123	-20	-0.196944693
1607	7/6/2014	22	50	60	-10	-0.218569843
1608	7/6/2014	23	44	46	-2	-0.051978678
1609	7/7/2014	0	67	57	10	0.143581039
1610	7/7/2014	1	127	132	-5	-0.046445954
1611	7/7/2014	2	258	248	10	0.038090306
1612	7/7/2014	3	343	393	-50	-0.146400336
1613	7/7/2014	4	612	519	93	0.151357681
1614	7/7/2014	5	893	846	47	0.052046583
1615	7/7/2014	6	1087	1049	38	0.034846885
1616	7/7/2014	7	1081	818	263	0.242815535
1617	7/7/2014	8	1035	972	63	0.060375683
1618	7/7/2014	9	1180	1206	-26	-0.022607685
1619	7/7/2014	10	1213	1256	-43	-0.036192509
1620	7/7/2014	11	1125	1183	-58	-0.052318535
1621	7/7/2014	12	1043	996	47	0.044555487
1622	7/7/2014	13	965	971	-6	-0.006705145
1623	7/7/2014	14	955	1015	-60	-0.063488328
1624	7/7/2014	15	1012	1012	0	-0.000931588
1625	7/7/2014	16	1027	1035	-8	-0.008631368
1626	7/7/2014	17	1109	1027	82	0.07374044
1627	7/7/2014	18	831	766	65	0.07802325
1628	7/7/2014	19	465	508	-43	-0.094145744
1629	7/7/2014	20	224	236	-12	-0.057229707
1630	7/7/2014	21	132	114	18	0.129610089
1631	7/7/2014	22	75	68	7	0.084422924
1632	7/7/2014	23	74	64	10	0.134372185
1633	7/8/2014	0	70	92	-22	-0.317158623
1634	7/8/2014	1	140	131	9	0.059404743
1635	7/8/2014	2	324	269	55	0.167751877
1636	7/8/2014	3	465	515	-50	-0.109128611
1637	7/8/2014	4	733	713	20	0.026528054
1638	7/8/2014	5	1023	950	73	0.070919159
1639	7/8/2014	6	1182	1253	-71	-0.060216292
1640	7/8/2014	7	1138	907	231	0.202531075
1641	7/8/2014	8	1113	1040	73	0.064692102
1642	7/8/2014	9	1211	1319	-108	-0.08998367
1643	7/8/2014	10	1190	1265	-75	-0.063367504
1644	7/8/2014	11	1141	1133	8	0.006180813
1645	7/8/2014	12	1039	1060	-21	-0.02116004
1646	7/8/2014	13	940	1009	-69	-0.073544795
1647	7/8/2014	14	977	1000	-23	-0.024480486
1648	7/8/2014	15	949	1036	-87	-0.092076181
1649	7/8/2014	16	1047	964	83	0.078958241
1650	7/8/2014	17	1069	1067	2	0.001427824
1651	7/8/2014	18	740	800	-60	-0.082084606
1652	7/8/2014	19	419	448	-29	-0.070524039
1653	7/8/2014	20	181	218	-37	-0.205051986
1654	7/8/2014	21	116	106	10	0.080991961
1655	7/8/2014	22	74	64	10	0.128133046
1656	7/8/2014	23	74	62	12	0.15008169
1657	7/9/2014	0	70	84	-14	-0.205709295
1658	7/9/2014	1	152	133	19	0.122597804
1659	7/9/2014	2	275	290	-15	-0.057707865
1660	7/9/2014	3	410	427	-17	-0.042995768
1661	7/9/2014	4	627	651	-24	-0.039259861
1662	7/9/2014	5	835	913	-78	-0.094599617
1663	7/9/2014	6	1002	1010	-8	-0.008102344
1664	7/9/2014	7	906	811	95	0.103939302
1665	7/9/2014	8	874	892	-18	-0.020684058
1666	7/9/2014	9	938	1091	-153	-0.163135577
1667	7/9/2014	10	1005	1046	-41	-0.041138177
1668	7/9/2014	11	1009	980	29	0.028200244
1669	7/9/2014	12	926	960	-34	-0.037621149
1670	7/9/2014	13	853	894	-41	-0.048105936
1671	7/9/2014	14	769	887	-118	-0.154143388
1672	7/9/2014	15	873	843	30	0.033558611
1673	7/9/2014	16	876	936	-60	-0.069026268
1674	7/9/2014	17	896	930	-34	-0.038551373
1675	7/9/2014	18	689	653	36	0.052178207
1676	7/9/2014	19	365	415	-50	-0.139162998
1677	7/9/2014	20	201	189	12	0.054952434
1678	7/9/2014	21	117	114	3	0.020133834
1679	7/9/2014	22	73	64	9	0.120084296
1680	7/9/2014	23	74	66	8	0.102301742
1681	7/10/2014	0	77	78	-1	-0.023542471
1682	7/10/2014	1	101	150	-49	-0.488069279
1683	7/10/2014	2	217	209	8	0.036404312
1684	7/10/2014	3	373	351	22	0.058316904
1685	7/10/2014	4	518	617	-99	-0.192932181
1686	7/10/2014	5	572	779	-207	-0.363382599
1687	7/10/2014	6	885	748	137	0.154378752
1688	7/10/2014	7	894	714	180	0.200504493
1689	7/10/2014	8	865	885	-20	-0.023316032
1690	7/10/2014	9	977	1025	-48	-0.049681797
1691	7/10/2014	10	1017	1060	-43	-0.043136754
1692	7/10/2014	11	1041	972	69	0.065976136
1693	7/10/2014	12	907	991	-84	-0.092766549
1694	7/10/2014	13	816	881	-65	-0.08046263
1695	7/10/2014	14	787	835	-48	-0.061755043
1696	7/10/2014	15	861	872	-11	-0.013865904
1697	7/10/2014	16	859	926	-67	-0.078318624
1698	7/10/2014	17	897	911	-14	-0.0166828
1699	7/10/2014	18	659	671	-12	-0.0183804
1700	7/10/2014	19	380	383	-3	-0.008025115
1701	7/10/2014	20	214	192	22	0.100982752
1702	7/10/2014	21	109	118	-9	-0.091715349
1703	7/10/2014	22	64	65	-1	-0.017052231
1704	7/10/2014	23	65	62	3	0.03676562
1705	7/11/2014	0	83	69	14	0.164958898
1706	7/11/2014	1	150	147	3	0.018300118
1707	7/11/2014	2	254	299	-45	-0.177685697
1708	7/11/2014	3	351	377	-26	-0.076571889
1709	7/11/2014	4	588	567	21	0.035500085
1710	7/11/2014	5	815	802	13	0.015473916
1711	7/11/2014	6	1035	1055	-20	-0.019540954
1712	7/11/2014	7	1040	1000	40	0.037826559
1713	7/11/2014	8	917	1001	-84	-0.092066805
1714	7/11/2014	9	958	1037	-79	-0.083420623
1715	7/11/2014	10	960	1017	-57	-0.060292558
1716	7/11/2014	11	1053	973	80	0.075819107
1717	7/11/2014	12	880	979	-99	-0.113176096
1718	7/11/2014	13	815	836	-21	-0.026936884
1719	7/11/2014	14	757	804	-47	-0.063013843
1720	7/11/2014	15	801	836	-35	-0.044611962
1721	7/11/2014	16	862	861	1	0.001027633
1722	7/11/2014	17	877	920	-43	-0.049261391
1723	7/11/2014	18	580	665	-85	-0.148221855
1724	7/11/2014	19	358	340	18	0.049078482
1725	7/11/2014	20	204	189	15	0.06980454
1726	7/11/2014	21	114	119	-5	-0.048537007
1727	7/11/2014	22	66	68	-2	-0.038399004
1728	7/11/2014	23	55	66	-11	-0.215369139
1729	7/12/2014	0	77	62	15	0.187928701
1730	7/12/2014	1	109	137	-28	-0.258746187
1731	7/12/2014	2	232	228	4	0.016239668
1732	7/12/2014	3	350	357	-7	-0.021605755
1733	7/12/2014	4	555	548	7	0.011408292
1734	7/12/2014	5	748	746	2	0.002472086
1735	7/12/2014	6	949	983	-34	-0.036576765
1736	7/12/2014	7	1025	933	92	0.089419435
1737	7/12/2014	8	964	951	13	0.013137778
1738	7/12/2014	9	951	1031	-80	-0.084516212
1739	7/12/2014	10	950	981	-31	-0.032711273
1740	7/12/2014	11	902	994	-92	-0.102543391
1741	7/12/2014	12	818	842	-24	-0.030496324
1742	7/12/2014	13	756	772	-16	-0.022445258
1743	7/12/2014	14	820	747	73	0.088024508
1744	7/12/2014	15	721	881	-160	-0.22317532
1745	7/12/2014	16	710	783	-73	-0.103771604
1746	7/12/2014	17	654	766	-112	-0.172705014
1747	7/12/2014	18	602	507	95	0.15756482
1748	7/12/2014	19	409	362	47	0.112963275
1749	7/12/2014	20	201	211	-10	-0.053890402
1750	7/12/2014	21	157	112	45	0.286079497
1751	7/12/2014	22	64	86	-22	-0.348556221
1752	7/12/2014	23	41	62	-21	-0.519499523
1753	7/13/2014	0	49	51	-2	-0.055320693
1754	7/13/2014	1	88	90	-2	-0.03175019
1755	7/13/2014	2	180	199	-19	-0.109020111
1756	7/13/2014	3	315	299	16	0.049142091
1757	7/13/2014	4	521	500	21	0.039337733
1758	7/13/2014	5	713	677	36	0.049289523
1759	7/13/2014	6	971	925	46	0.046515304
1760	7/13/2014	7	947	945	2	0.001893139
1761	7/13/2014	8	844	875	-31	-0.037517164
1762	7/13/2014	9	857	911	-54	-0.063133153
1763	7/13/2014	10	829	901	-72	-0.087016085
1764	7/13/2014	11	769	878	-109	-0.143004511
1765	7/13/2014	12	845	723	122	0.143386194
1766	7/13/2014	13	931	804	127	0.135521335
1767	7/13/2014	14	1171	891	280	0.238848714
1768	7/13/2014	15	1311	1076	235	0.178862314
1769	7/13/2014	16	1220	1160	60	0.048773921
1770	7/13/2014	17	1149	1087	62	0.053176915
1771	7/13/2014	18	741	797	-56	-0.07600269
1772	7/13/2014	19	402	433	-31	-0.078873746
1773	7/13/2014	20	198	227	-29	-0.146725504
1774	7/13/2014	21	108	123	-15	-0.145880044
1775	7/13/2014	22	108	61	47	0.426759312
1776	7/13/2014	23	60	85	-25	-0.425919184
1777	7/14/2014	0	65	74	-9	-0.150570996
1778	7/14/2014	1	130	102	28	0.215243571
1779	7/14/2014	2	235	253	-18	-0.078793949
1780	7/14/2014	3	382	387	-5	-0.01541471
1781	7/14/2014	4	602	582	20	0.03199828
1782	7/14/2014	5	882	767	115	0.130027132
1783	7/14/2014	6	1144	1163	-19	-0.016860018
1784	7/14/2014	7	1169	1144	25	0.020750199
1785	7/14/2014	8	1111	1042	69	0.061315601
1786	7/14/2014	9	1245	1114	131	0.105201159
1787	7/14/2014	10	1264	1214	50	0.039145019
1788	7/14/2014	11	1265	1199	66	0.051683947
1789	7/14/2014	12	1091	1113	-22	-0.020256308
1790	7/14/2014	13	1018	1015	3	0.002413748
1791	7/14/2014	14	1100	1057	43	0.038327523
1792	7/14/2014	15	1085	1115	-30	-0.028283423
1793	7/14/2014	16	1186	1051	135	0.113684695
1794	7/14/2014	17	1107	1129	-22	-0.020628577
1795	7/14/2014	18	748	797	-49	-0.06626746
1796	7/14/2014	19	435	440	-5	-0.013209548
1797	7/14/2014	20	245	226	19	0.073763589
1798	7/14/2014	21	135	148	-13	-0.098937905
1799	7/14/2014	22	71	82	-11	-0.161130542
1800	7/14/2014	23	62	53	9	0.137595142
1801	7/15/2014	0	73	76	-3	-0.045126578
1802	7/15/2014	1	148	126	22	0.14192972
1803	7/15/2014	2	266	271	-5	-0.022068634
1804	7/15/2014	3	406	405	1	0.001037539
1805	7/15/2014	4	655	652	3	0.004125208
1806	7/15/2014	5	943	897	46	0.048389908
1807	7/15/2014	6	1044	1209	-165	-0.15861378
1808	7/15/2014	7	1051	1076	-25	-0.024031069
1809	7/15/2014	8	1000	980	20	0.019264032
1810	7/15/2014	9	1057	1067	-10	-0.010289301
1811	7/15/2014	10	1103	1058	45	0.039922573
1812	7/15/2014	11	1151	1075	76	0.065321896
1813	7/15/2014	12	997	1035	-38	-0.038714714
1814	7/15/2014	13	899	954	-55	-0.061708062
1815	7/15/2014	14	1005	972	33	0.03185427
1816	7/15/2014	15	1059	1020	39	0.035987524
1817	7/15/2014	16	1126	1094	32	0.027750651
1818	7/15/2014	17	1088	1038	50	0.04584833
1819	7/15/2014	18	765	755	10	0.011979183
1820	7/15/2014	19	444	451	-7	-0.017665825
1821	7/15/2014	20	235	231	4	0.013320327
1822	7/15/2014	21	122	137	-15	-0.128906498
1823	7/15/2014	22	53	75	-22	-0.427569949
1824	7/15/2014	23	49	41	8	0.153882031
1825	7/16/2014	0	87	62	25	0.285041747
1826	7/16/2014	1	115	155	-40	-0.350714219
1827	7/16/2014	2	234	223	11	0.046255024
1828	7/16/2014	3	408	357	51	0.124948204
1829	7/16/2014	4	680	639	41	0.059816238
1830	7/16/2014	5	829	946	-117	-0.141214355
1831	7/16/2014	6	989	1028	-39	-0.039765853
1832	7/16/2014	7	963	1024	-61	-0.064038168
1833	7/16/2014	8	1055	941	114	0.107418889
1834	7/16/2014	9	1155	1116	39	0.033431435
1835	7/16/2014	10	1087	1150	-63	-0.058582969
1836	7/16/2014	11	1039	1059	-20	-0.019291509
1837	7/16/2014	12	964	960	4	0.003332506
1838	7/16/2014	13	873	931	-58	-0.067435085
1839	7/16/2014	14	954	1011	-57	-0.060368803
1840	7/16/2014	15	985	993	-8	-0.008279665
1841	7/16/2014	16	1066	1032	34	0.031080254
1842	7/16/2014	17	1082	1015	67	0.061698148
1843	7/16/2014	18	910	770	140	0.153387394
1844	7/16/2014	19	517	517	0	-0.001504539
1845	7/16/2014	20	301	254	47	0.154925126
1846	7/16/2014	21	129	162	-33	-0.259873323
1847	7/16/2014	22	85	71	14	0.153790454
1848	7/16/2014	23	75	61	14	0.174915395
1849	7/17/2014	0	72	91	-19	-0.266366223
1850	7/17/2014	1	156	128	28	0.175243932
1851	7/17/2014	2	329	278	51	0.153022551
1852	7/17/2014	3	472	513	-41	-0.087666607
1853	7/17/2014	4	727	755	-28	-0.039708592
1854	7/17/2014	5	1047	956	91	0.08641598
1855	7/17/2014	6	1172	1258	-86	-0.074009676
1856	7/17/2014	7	1125	1179	-54	-0.048680058
1857	7/17/2014	8	1179	1094	85	0.071623334
1858	7/17/2014	9	1172	1243	-71	-0.061014114
1859	7/17/2014	10	1239	1182	57	0.045298747
1860	7/17/2014	11	1216	1194	22	0.017832918
1861	7/17/2014	12	1106	1099	7	0.005675477
1862	7/17/2014	13	962	1052	-90	-0.094307601
1863	7/17/2014	14	1022	1101	-79	-0.077816304
1864	7/17/2014	15	972	1105	-133	-0.137478682
1865	7/17/2014	16	968	1066	-98	-0.102132384
1866	7/17/2014	17	1059	1005	54	0.050423932
1867	7/17/2014	18	832	801	31	0.036623819
1868	7/17/2014	19	479	473	6	0.012240863
1869	7/17/2014	20	238	256	-18	-0.0768837
1870	7/17/2014	21	131	122	9	0.063724853
1871	7/17/2014	22	92	79	13	0.133674196
1872	7/17/2014	23	92	70	22	0.232864084
1873	7/18/2014	0	92	105	-13	-0.146935074
1874	7/18/2014	1	120	159	-39	-0.325781014
1875	7/18/2014	2	291	236	55	0.187647157
1876	7/18/2014	3	433	466	-33	-0.077484103
1877	7/18/2014	4	896	720	176	0.195966396
1878	7/18/2014	5	1185	1171	14	0.011466773
1879	7/18/2014	6	783	1319	-536	-0.685794997
1880	7/18/2014	7	231	842	-611	-2.647745408
1881	7/18/2014	8	230	334	-104	-0.45327821
1882	7/18/2014	9	1075	377	698	0.648690567
1883	7/18/2014	10	1081	1258	-177	-0.164639274
1884	7/18/2014	11	1139	1147	-8	-0.007559389
1885	7/18/2014	12	1491	892	599	0.401549879
1886	7/18/2014	13	1336	1103	233	0.173760148
1887	7/18/2014	14	1220	1328	-108	-0.089251992
1888	7/18/2014	15	1261	1088	173	0.136787988
1889	7/18/2014	16	1283	1218	65	0.04993457
1890	7/18/2014	17	1266	1283	-17	-0.014004253
1891	7/18/2014	18	948	952	-4	-0.005000187
1892	7/18/2014	19	585	533	52	0.087222085
1893	7/18/2014	20	303	304	-1	-0.004511373
1894	7/18/2014	21	193	151	42	0.213035706
1895	7/18/2014	22	94	102	-8	-0.085536169
1896	7/18/2014	23	85	82	3	0.02851135
1897	7/19/2014	0	92	94	-2	-0.03201084
1898	7/19/2014	1	151	151	0	-0.003726138
1899	7/19/2014	2	315	304	11	0.034058191
1900	7/19/2014	3	491	464	27	0.054066634
1901	7/19/2014	4	742	882	-140	-0.189321863
1902	7/19/2014	5	1092	1033	59	0.053571529
1903	7/19/2014	6	1286	1026	260	0.201611867
1904	7/19/2014	7	1364	877	487	0.356584026
1905	7/19/2014	8	1270	1244	26	0.020369415
1906	7/19/2014	9	1227	1698	-471	-0.384626619
1907	7/19/2014	10	1257	1244	13	0.009984924
1908	7/19/2014	11	1124	1291	-167	-0.149345983
1909	7/19/2014	12	1134	1164	-30	-0.02649439
1910	7/19/2014	13	1068	1053	15	0.013244816
1911	7/19/2014	14	1099	1143	-44	-0.040657941
1912	7/19/2014	15	1086	1171	-85	-0.079169191
1913	7/19/2014	16	1027	1171	-144	-0.140264828
1914	7/19/2014	17	1056	1079	-23	-0.022595656
1915	7/19/2014	18	756	836	-80	-0.106455001
1916	7/19/2014	19	484	470	14	0.027187624
1917	7/19/2014	20	273	267	6	0.021485565
1918	7/19/2014	21	133	145	-12	-0.090374338
1919	7/19/2014	22	62	77	-15	-0.252089223
1920	7/19/2014	23	63	61	2	0.026876144
1921	7/20/2014	0	61	76	-15	-0.257795565
1922	7/20/2014	1	116	106	10	0.083042124
1923	7/20/2014	2	232	274	-42	-0.182628112
1924	7/20/2014	3	391	395	-4	-0.011531535
1925	7/20/2014	4	608	658	-50	-0.082704378
1926	7/20/2014	5	890	861	29	0.032575289
1927	7/20/2014	6	1086	956	130	0.118882727
1928	7/20/2014	7	1190	777	413	0.346590818
1929	7/20/2014	8	1070	1064	6	0.005304485
1930	7/20/2014	9	1006	1475	-469	-0.467045729
1931	7/20/2014	10	981	962	19	0.018387517
1932	7/20/2014	11	916	963	-47	-0.051938934
1933	7/20/2014	12	945	1089	-144	-0.152920713
1934	7/20/2014	13	935	943	-8	-0.008593028
1935	7/20/2014	14	1053	975	78	0.07330826
1936	7/20/2014	15	1056	1053	3	0.002117854
1937	7/20/2014	16	1087	1043	44	0.039685106
1938	7/20/2014	17	1037	1081	-44	-0.042639725
1939	7/20/2014	18	814	805	9	0.010083579
1940	7/20/2014	19	354	493	-139	-0.393328034
1941	7/20/2014	20	160	206	-46	-0.293420492
1942	7/20/2014	21	78	96	-18	-0.230999845
1943	7/20/2014	22	48	51	-3	-0.081445298
1944	7/20/2014	23	43	53	-10	-0.233584925
1945	7/21/2014	0	53	49	4	0.059582011
1946	7/21/2014	1	102	98	4	0.034549938
1947	7/21/2014	2	201	227	-26	-0.130422009
1948	7/21/2014	3	368	323	45	0.120406269
1949	7/21/2014	4	562	611	-49	-0.087906008
1950	7/21/2014	5	793	838	-45	-0.057037371
1951	7/21/2014	6	1013	839	174	0.170923612
1952	7/21/2014	7	1124	768	356	0.316158801
1953	7/21/2014	8	1047	1008	39	0.036618181
1954	7/21/2014	9	1154	1354	-200	-0.173691216
1955	7/21/2014	10	1194	1122	72	0.060002165
1956	7/21/2014	11	1027	1127	-100	-0.097620553
1957	7/21/2014	12	956	1124	-168	-0.176181129
1958	7/21/2014	13	914	946	-32	-0.035321602
1959	7/21/2014	14	966	988	-22	-0.023178403
1960	7/21/2014	15	1001	1017	-16	-0.016102839
1961	7/21/2014	16	1211	1031	180	0.148523586
1962	7/21/2014	17	1148	1199	-51	-0.045278324
1963	7/21/2014	18	866	844	22	0.025249221
1964	7/21/2014	19	490	473	17	0.032812068
1965	7/21/2014	20	236	245	-9	-0.040796012
1966	7/21/2014	21	111	126	-15	-0.135392349
1967	7/21/2014	22	82	64	18	0.215042084
1968	7/21/2014	23	70	77	-7	-0.108210774
1969	7/22/2014	0	79	75	4	0.047053647
1970	7/22/2014	1	156	129	27	0.170482302
1971	7/22/2014	2	324	315	9	0.027566414
1972	7/22/2014	3	481	516	-35	-0.074256231
1973	7/22/2014	4	743	752	-9	-0.013168884
1974	7/22/2014	5	898	1047	-149	-0.166802294
1975	7/22/2014	6	1034	1018	16	0.014720421
1976	7/22/2014	7	1146	868	278	0.241912994
1977	7/22/2014	8	1129	1030	99	0.087664803
1978	7/22/2014	9	1116	1503	-387	-0.347392373
1979	7/22/2014	10	1148	1091	57	0.048981529
1980	7/22/2014	11	1016	1055	-39	-0.038695715
1981	7/22/2014	12	1042	1143	-101	-0.097352402
1982	7/22/2014	13	1000	1039	-39	-0.039571422
1983	7/22/2014	14	1043	1063	-20	-0.019736541
1984	7/22/2014	15	1079	1102	-23	-0.021387971
1985	7/22/2014	16	1105	1146	-41	-0.037930792
1986	7/22/2014	17	1139	1103	36	0.030963024
1987	7/22/2014	18	873	869	4	0.003936882
1988	7/22/2014	19	390	482	-92	-0.237475487
1989	7/22/2014	20	222	205	17	0.073970793
1990	7/22/2014	21	108	118	-10	-0.093486624
1991	7/22/2014	22	76	64	12	0.150783691
1992	7/22/2014	23	70	68	2	0.016348877
1993	7/23/2014	0	87	75	12	0.130051289
1994	7/23/2014	1	165	152	13	0.075235391
1995	7/23/2014	2	231	313	-82	-0.357422397
1996	7/23/2014	3	449	391	58	0.127040865
1997	7/23/2014	4	637	678	-41	-0.065788089
1998	7/23/2014	5	889	916	-27	-0.031307136
1999	7/23/2014	6	1079	1107	-28	-0.026309424
2000	7/23/2014	7	1048	1184	-136	-0.130317945
2001	7/23/2014	8	1011	1034	-23	-0.02293932
2002	7/23/2014	9	1074	1048	26	0.023785388
2003	7/23/2014	10	1076	1116	-40	-0.037668409
2004	7/23/2014	11	1155	973	182	0.156949783
2005	7/23/2014	12	1050	1117	-67	-0.063812977
2006	7/23/2014	13	927	1012	-85	-0.09174625
2007	7/23/2014	14	994	981	13	0.012791944
2008	7/23/2014	15	1033	1015	18	0.016780994
2009	7/23/2014	16	1007	1119	-112	-0.111782135
2010	7/23/2014	17	1137	1030	107	0.093830569
2011	7/23/2014	18	858	848	10	0.010620215
2012	7/23/2014	19	457	445	12	0.024850384
2013	7/23/2014	20	238	232	6	0.02252422
2014	7/23/2014	21	98	110	-12	-0.125070361
2015	7/23/2014	22	83	63	20	0.23521689
2016	7/23/2014	23	87	73	14	0.156762783
2017	7/24/2014	0	86	92	-6	-0.076997635
2018	7/24/2014	1	158	156	2	0.011557193
2019	7/24/2014	2	289	275	14	0.04826693
2020	7/24/2014	3	409	486	-77	-0.189158906
2021	7/24/2014	4	636	646	-10	-0.017100516
2022	7/24/2014	5	914	890	24	0.025965637
2023	7/24/2014	6	1103	1132	-29	-0.027027787
2024	7/24/2014	7	1068	1209	-141	-0.132167407
2025	7/24/2014	8	993	1021	-28	-0.029203137
2026	7/24/2014	9	1063	1037	26	0.024100629
2027	7/24/2014	10	1054	1120	-66	-0.062797532
2028	7/24/2014	11	1048	1017	31	0.0293762
2029	7/24/2014	12	923	1018	-95	-0.103454202
2030	7/24/2014	13	883	893	-10	-0.012196412
2031	7/24/2014	14	972	976	-4	-0.004666235
2032	7/24/2014	15	982	1030	-48	-0.04973743
2033	7/24/2014	16	1034	1063	-29	-0.028711571
2034	7/24/2014	17	989	1077	-88	-0.089248101
2035	7/24/2014	18	764	800	-36	-0.047794136
2036	7/24/2014	19	423	388	35	0.081789632
2037	7/24/2014	20	185	214	-29	-0.15958767
2038	7/24/2014	21	135	91	44	0.324428556
2039	7/24/2014	22	67	90	-23	-0.349514036
2040	7/24/2014	23	56	63	-7	-0.126879347
2041	7/25/2014	0	99	66	33	0.327970765
2042	7/25/2014	1	147	178	-31	-0.21696242
2043	7/25/2014	2	289	269	20	0.068783543
2044	7/25/2014	3	391	458	-67	-0.17242397
2045	7/25/2014	4	545	599	-54	-0.100781982
2046	7/25/2014	5	750	791	-41	-0.055581741
2047	7/25/2014	6	858	960	-102	-0.119253663
2048	7/25/2014	7	870	945	-75	-0.086800715
2049	7/25/2014	8	811	882	-71	-0.088618043
2050	7/25/2014	9	890	922	-32	-0.036767516
2051	7/25/2014	10	859	944	-85	-0.099759694
2052	7/25/2014	11	967	868	99	0.101593089
2053	7/25/2014	12	860	922	-62	-0.07294159
2054	7/25/2014	13	814	828	-14	-0.017251494
2055	7/25/2014	14	844	886	-42	-0.050348134
2056	7/25/2014	15	776	881	-105	-0.135465832
2057	7/25/2014	16	870	890	-20	-0.023133689
2058	7/25/2014	17	817	930	-113	-0.138458517
2059	7/25/2014	18	628	654	-26	-0.04175729
2060	7/25/2014	19	404	356	48	0.117257636
2061	7/25/2014	20	237	209	28	0.116964964
2062	7/25/2014	21	120	116	4	0.028290567
2063	7/25/2014	22	72	78	-6	-0.095603694
2064	7/25/2014	23	45	65	-20	-0.454618883
2065	7/26/2014	0	62	60	2	0.022889103
2066	7/26/2014	1	117	122	-5	-0.048557513
2067	7/26/2014	2	256	234	22	0.083002925
2068	7/26/2014	3	391	400	-9	-0.024378998
2069	7/26/2014	4	752	580	172	0.227594856
2070	7/26/2014	5	944	955	-11	-0.011825161
2071	7/26/2014	6	1126	1070	56	0.049496792
2072	7/26/2014	7	1079	1094	-15	-0.014206364
2073	7/26/2014	8	1065	995	70	0.065258379
2074	7/26/2014	9	896	1107	-211	-0.235514862
2075	7/26/2014	10	960	932	28	0.028633937
2076	7/26/2014	11	887	1005	-118	-0.133841831
2077	7/26/2014	12	894	870	24	0.02666463
2078	7/26/2014	13	785	868	-83	-0.106933958
2079	7/26/2014	14	844	864	-20	-0.023764197
2080	7/26/2014	15	898	884	14	0.015060908
2081	7/26/2014	16	851	945	-94	-0.110953119
2082	7/26/2014	17	820	897	-77	-0.095038419
2083	7/26/2014	18	678	663	15	0.02146843
2084	7/26/2014	19	371	378	-7	-0.020604887
2085	7/26/2014	20	237	201	36	0.151254793
2086	7/26/2014	21	120	124	-4	-0.037787347
2087	7/26/2014	22	61	75	-14	-0.230995236
2088	7/26/2014	23	60	52	8	0.121138795
2089	7/27/2014	0	46	81	-35	-0.766651898
2090	7/27/2014	1	107	94	13	0.112853127
2091	7/27/2014	2	210	215	-5	-0.026292886
2092	7/27/2014	3	363	358	5	0.013281945
2093	7/27/2014	4	561	589	-28	-0.05004089
2094	7/27/2014	5	762	763	-1	-0.001840898
2095	7/27/2014	6	888	920	-32	-0.036701037
2096	7/27/2014	7	1064	888	176	0.164796122
2097	7/27/2014	8	918	1002	-84	-0.091968843
2098	7/27/2014	9	840	936	-96	-0.114734158
2099	7/27/2014	10	838	864	-26	-0.032192292
2100	7/27/2014	11	870	893	-23	-0.026478318
2101	7/27/2014	12	801	840	-39	-0.0488787
2102	7/27/2014	13	903	765	138	0.151783179
2103	7/27/2014	14	960	954	6	0.005533783
2104	7/27/2014	15	966	944	22	0.02217195
2105	7/27/2014	16	944	970	-26	-0.028419085
2106	7/27/2014	17	919	910	9	0.009550281
2107	7/27/2014	18	683	723	-40	-0.059392229
2108	7/27/2014	19	350	397	-47	-0.135809475
2109	7/27/2014	20	191	199	-8	-0.043479272
2110	7/27/2014	21	116	105	11	0.094490701
2111	7/27/2014	22	55	71	-16	-0.296872624
2112	7/27/2014	23	41	49	-8	-0.19628807
2113	7/28/2014	0	55	51	4	0.064921703
2114	7/28/2014	1	134	109	25	0.180890007
2115	7/28/2014	2	191	271	-80	-0.422301292
2116	7/28/2014	3	329	304	25	0.074887058
2117	7/28/2014	4	613	529	84	0.135601525
2118	7/28/2014	5	812	835	-23	-0.029409889
2119	7/28/2014	6	979	976	3	0.002458195
2120	7/28/2014	7	1076	978	98	0.090442521
2121	7/28/2014	8	992	986	6	0.005719406
2122	7/28/2014	9	1103	966	137	0.123974502
2123	7/28/2014	10	1141	1054	87	0.076105739
2124	7/28/2014	11	1050	1095	-45	-0.043685325
2125	7/28/2014	12	875	960	-85	-0.097789081
2126	7/28/2014	13	849	856	-7	-0.008809424
2127	7/28/2014	14	872	919	-47	-0.054268894
2128	7/28/2014	15	825	903	-78	-0.0955485
2129	7/28/2014	16	1037	875	162	0.156216676
2130	7/28/2014	17	941	987	-46	-0.049647768
2131	7/28/2014	18	732	725	7	0.009211272
2132	7/28/2014	19	436	403	33	0.07447134
2133	7/28/2014	20	261	237	24	0.091936113
2134	7/28/2014	21	108	144	-36	-0.341506521
2135	7/28/2014	22	63	56	7	0.097422928
2136	7/28/2014	23	44	50	-6	-0.158690596
2137	7/29/2014	0	56	58	-2	-0.038009225
2138	7/29/2014	1	155	118	37	0.233875489
2139	7/29/2014	2	251	279	-28	-0.112771859
2140	7/29/2014	3	501	397	104	0.206471996
2141	7/29/2014	4	735	767	-32	-0.044769287
2142	7/29/2014	5	935	945	-10	-0.011070691
2143	7/29/2014	6	1181	1076	105	0.088725692
2144	7/29/2014	7	1265	1214	51	0.040138413
2145	7/29/2014	8	1177	1148	29	0.024220436
2146	7/29/2014	9	1139	1112	27	0.02360067
2147	7/29/2014	10	1147	1125	22	0.018699071
2148	7/29/2014	11	1041	1129	-88	-0.084870317
2149	7/29/2014	12	1025	939	86	0.083669076
2150	7/29/2014	13	1008	977	31	0.030526278
2151	7/29/2014	14	1014	1046	-32	-0.032009384
2152	7/29/2014	15	1006	1002	4	0.002999903
2153	7/29/2014	16	1079	1043	36	0.032773347
2154	7/29/2014	17	950	1007	-57	-0.060506561
2155	7/29/2014	18	740	749	-9	-0.013340573
2156	7/29/2014	19	414	418	-4	-0.010339711
2157	7/29/2014	20	194	245	-51	-0.266213175
2158	7/29/2014	21	121	105	16	0.131909465
2159	7/29/2014	22	73	66	7	0.092616503
2160	7/29/2014	23	48	54	-6	-0.130478204
2161	7/30/2014	0	63	56	7	0.101863796
2162	7/30/2014	1	125	141	-16	-0.135882874
2163	7/30/2014	2	247	225	22	0.08531153
2164	7/30/2014	3	406	427	-21	-0.053076727
2165	7/30/2014	4	610	684	-74	-0.122468945
2166	7/30/2014	5	850	822	28	0.031913087
2167	7/30/2014	6	987	1039	-52	-0.052808759
2168	7/30/2014	7	1046	1115	-69	-0.066846972
2169	7/30/2014	8	999	1000	-1	-0.001067932
2170	7/30/2014	9	1055	978	77	0.072417406
2171	7/30/2014	10	1137	1080	57	0.04948179
2172	7/30/2014	11	1067	1049	18	0.016153025
2173	7/30/2014	12	951	969	-18	-0.019458742
2174	7/30/2014	13	935	929	6	0.00560406
2175	7/30/2014	14	921	977	-56	-0.061233224
2176	7/30/2014	15	951	914	37	0.038298052
2177	7/30/2014	16	1103	1020	83	0.074611608
2178	7/30/2014	17	1156	1024	132	0.114080346
2179	7/30/2014	18	839	854	-15	-0.01834329
2180	7/30/2014	19	447	448	-1	-0.003362689
2181	7/30/2014	20	243	242	1	0.001762188
2182	7/30/2014	21	141	126	15	0.102767652
2183	7/30/2014	22	74	74	0	-0.006311836
2184	7/30/2014	23	42	55	-13	-0.312994418
2185	7/31/2014	0	63	50	13	0.206130917
2186	7/31/2014	1	148	146	2	0.007566248
2187	7/31/2014	2	284	256	28	0.097206874
2188	7/31/2014	3	406	481	-75	-0.185022667
2189	7/31/2014	4	612	641	-29	-0.048659943
2190	7/31/2014	5	900	835	65	0.071299234
2191	7/31/2014	6	1063	1090	-27	-0.026132609
2192	7/31/2014	7	1043	1188	-145	-0.139940937
2193	7/31/2014	8	1082	978	104	0.095823773
2194	7/31/2014	9	1176	1095	81	0.068752821
2195	7/31/2014	10	1239	1209	30	0.023851283
2196	7/31/2014	11	1020	1145	-125	-0.12331864
2197	7/31/2014	12	1040	923	117	0.111841527
2198	7/31/2014	13	1009	1030	-21	-0.021156743
2199	7/31/2014	14	1050	1028	22	0.020528529
2200	7/31/2014	15	1171	1045	126	0.107112225
2201	7/31/2014	16	1155	1257	-102	-0.088663941
2202	7/31/2014	17	1125	1096	29	0.025674653
2203	7/31/2014	18	899	831	68	0.074912666
2204	7/31/2014	19	502	481	21	0.041167433
2205	7/31/2014	20	268	263	5	0.018315657
2206	7/31/2014	21	100	143	-43	-0.438370697
2207	7/31/2014	22	53	57	-4	-0.091422683
2208	7/31/2014	23	52	37	15	0.276111216
2209	8/1/2014	0	86	71	15	0.167307098
2210	8/1/2014	1	132	194	-62	-0.4705916
2211	8/1/2014	2	256	227	29	0.112112277
2212	8/1/2014	3	393	416	-23	-0.059621475
2213	8/1/2014	4	649	645	4	0.005718654
2214	8/1/2014	5	877	909	-32	-0.037196955
2215	8/1/2014	6	1037	1049	-12	-0.012238458
2216	8/1/2014	7	1027	1130	-103	-0.100544328
2217	8/1/2014	8	984	1025	-41	-0.0422712
2218	8/1/2014	9	1057	1061	-4	-0.003960387
2219	8/1/2014	10	1023	1134	-111	-0.109249736
2220	8/1/2014	11	1058	963	95	0.089199968
2221	8/1/2014	12	936	985	-49	-0.052356087
2222	8/1/2014	13	871	930	-59	-0.068586649
2223	8/1/2014	14	903	911	-8	-0.009108981
2224	8/1/2014	15	924	937	-13	-0.014928127
2225	8/1/2014	16	1053	1051	2	0.001221355
2226	8/1/2014	17	1056	1005	51	0.047933391
2227	8/1/2014	18	854	817	37	0.042882287
2228	8/1/2014	19	533	483	50	0.092771525
2229	8/1/2014	20	329	269	60	0.182179047
2230	8/1/2014	21	199	147	52	0.259810693
2231	8/1/2014	22	118	98	20	0.167937414
2232	8/1/2014	23	95	72	23	0.235709085
2233	8/2/2014	0	82	114	-32	-0.390516186
2234	8/2/2014	1	191	164	27	0.136726459
2235	8/2/2014	2	371	332	39	0.103487862
2236	8/2/2014	3	534	581	-47	-0.088289856
2237	8/2/2014	4	784	827	-43	-0.055570243
2238	8/2/2014	5	1107	1050	57	0.050985143
2239	8/2/2014	6	1356	1322	34	0.024494193
2240	8/2/2014	7	1355	1352	3	0.002190269
2241	8/2/2014	8	1372	1262	110	0.079918486
2242	8/2/2014	9	1315	1379	-64	-0.049226605
2243	8/2/2014	10	1310	1338	-28	-0.021407394
2244	8/2/2014	11	1261	1192	69	0.054335236
2245	8/2/2014	12	1308	1171	137	0.104707638
2246	8/2/2014	13	1177	1231	-54	-0.046718966
2247	8/2/2014	14	1152	1163	-11	-0.010063348
2248	8/2/2014	15	1164	1178	-14	-0.012087718
2249	8/2/2014	16	1227	1272	-45	-0.036932444
2250	8/2/2014	17	1214	1229	-15	-0.012599197
2251	8/2/2014	18	1040	959	81	0.077492362
2252	8/2/2014	19	634	569	65	0.101982601
2253	8/2/2014	20	325	333	-8	-0.026372119
2254	8/2/2014	21	177	169	8	0.044140465
2255	8/2/2014	22	81	94	-13	-0.172191287
2256	8/2/2014	23	85	60	25	0.289565484
2257	8/3/2014	0	70	103	-33	-0.484321455
2258	8/3/2014	1	137	146	-9	-0.070563353
2259	8/3/2014	2	243	277	-34	-0.140020459
2260	8/3/2014	3	422	403	19	0.043563543
2261	8/3/2014	4	749	690	59	0.078426692
2262	8/3/2014	5	1002	1035	-33	-0.033146165
2263	8/3/2014	6	1188	1170	18	0.01483393
2264	8/3/2014	7	1274	1183	91	0.07112508
2265	8/3/2014	8	1163	1243	-80	-0.069392248
2266	8/3/2014	9	1135	1208	-73	-0.064398915
2267	8/3/2014	10	1074	1162	-88	-0.082465618
2268	8/3/2014	11	1047	1053	-6	-0.00656753
2269	8/3/2014	12	1094	1040	54	0.048998699
2270	8/3/2014	13	1176	1045	131	0.111321066
2271	8/3/2014	14	1202	1159	43	0.03516525
2272	8/3/2014	15	1096	1195	-99	-0.090900155
2273	8/3/2014	16	1108	1162	-54	-0.049401482
2274	8/3/2014	17	1061	1098	-37	-0.035776302
2275	8/3/2014	18	938	883	55	0.058373993
2276	8/3/2014	19	526	560	-34	-0.064768192
2277	8/3/2014	20	254	290	-36	-0.144181318
2278	8/3/2014	21	125	133	-8	-0.07177282
2279	8/3/2014	22	73	69	4	0.051978062
2280	8/3/2014	23	41	63	-22	-0.553283637
2281	8/4/2014	0	64	52	12	0.1806523
2282	8/4/2014	1	186	133	53	0.280118599
2283	8/4/2014	2	263	340	-77	-0.294802643
2284	8/4/2014	3	432	407	25	0.056905589
2285	8/4/2014	4	678	656	22	0.032299836
2286	8/4/2014	5	982	959	23	0.023384244
2287	8/4/2014	6	1276	1201	75	0.058531029
2288	8/4/2014	7	1297	1233	64	0.048619412
2289	8/4/2014	8	1218	1235	-17	-0.01470373
2290	8/4/2014	9	1338	1240	98	0.072943688
2291	8/4/2014	10	1321	1294	27	0.020040372
2292	8/4/2014	11	1224	1215	9	0.006613807
2293	8/4/2014	12	1211	1199	12	0.009097728
2294	8/4/2014	13	1130	1161	-31	-0.027514163
2295	8/4/2014	14	1054	1146	-92	-0.087898969
2296	8/4/2014	15	1299	1079	220	0.16888721
2297	8/4/2014	16	1326	1316	10	0.007199392
2298	8/4/2014	17	1313	1308	5	0.003580177
2299	8/4/2014	18	1039	1052	-13	-0.01253936
2300	8/4/2014	19	583	591	-8	-0.014065593
2301	8/4/2014	20	315	321	-6	-0.019796652
2302	8/4/2014	21	156	158	-2	-0.015092387
2303	8/4/2014	22	79	82	-3	-0.047729867
2304	8/4/2014	23	79	66	13	0.153801283
2305	8/5/2014	0	75	89	-14	-0.192178228
2306	8/5/2014	1	164	162	2	0.007256312
2307	8/5/2014	2	292	291	1	0.001509386
2308	8/5/2014	3	486	467	19	0.038555788
2309	8/5/2014	4	787	786	1	0.000409665
2310	8/5/2014	5	1102	1080	22	0.019356033
2311	8/5/2014	6	1315	1329	-14	-0.011376965
2312	8/5/2014	7	1274	1359	-85	-0.067379527
2313	8/5/2014	8	1268	1238	30	0.023322281
2314	8/5/2014	9	1406	1278	128	0.09040059
2315	8/5/2014	10	1416	1352	64	0.045164293
2316	8/5/2014	11	1426	1359	67	0.046355573
2317	8/5/2014	12	1281	1346	-65	-0.051436385
2318	8/5/2014	13	1197	1199	-2	-0.001776952
2319	8/5/2014	14	1221	1184	37	0.030208616
2320	8/5/2014	15	1244	1265	-21	-0.017463478
2321	8/5/2014	16	1312	1323	-11	-0.008460078
2322	8/5/2014	17	1367	1262	105	0.076382625
2323	8/5/2014	18	1021	1130	-109	-0.107292361
2324	8/5/2014	19	585	605	-20	-0.034732656
2325	8/5/2014	20	260	307	-47	-0.182668283
2326	8/5/2014	21	151	145	6	0.035721649
2327	8/5/2014	22	86	85	1	0.006599167
2328	8/5/2014	23	54	71	-17	-0.333040364
2329	8/6/2014	0	82	59	23	0.273838017
2330	8/6/2014	1	202	186	16	0.075600599
2331	8/6/2014	2	347	332	15	0.040406649
2332	8/6/2014	3	490	537	-47	-0.096346451
2333	8/6/2014	4	713	762	-49	-0.06875276
2334	8/6/2014	5	1017	1022	-5	-0.005758009
2335	8/6/2014	6	1211	1287	-76	-0.063270386
2336	8/6/2014	7	1252	1261	-9	-0.007589662
2337	8/6/2014	8	1196	1225	-29	-0.025077275
2338	8/6/2014	9	1296	1294	2	0.000947391
2339	8/6/2014	10	1271	1299	-28	-0.022120669
2340	8/6/2014	11	1281	1220	61	0.04731855
2341	8/6/2014	12	1174	1266	-92	-0.078486188
2342	8/6/2014	13	1206	1142	64	0.053034298
2343	8/6/2014	14	1169	1183	-14	-0.012293242
2344	8/6/2014	15	1259	1218	41	0.031967181
2345	8/6/2014	16	1238	1296	-58	-0.04687827
2346	8/6/2014	17	1230	1258	-28	-0.023105385
2347	8/6/2014	18	854	995	-141	-0.166022802
2348	8/6/2014	19	545	513	32	0.058612183
2349	8/6/2014	20	274	282	-8	-0.031165781
2350	8/6/2014	21	128	148	-20	-0.162187942
2351	8/6/2014	22	87	69	18	0.199503463
2352	8/6/2014	23	58	67	-9	-0.15983759
2353	8/7/2014	0	83	70	13	0.156374257
2354	8/7/2014	1	168	188	-20	-0.120982316
2355	8/7/2014	2	282	283	-1	-0.006176753
2356	8/7/2014	3	508	453	55	0.107106377
2357	8/7/2014	4	739	790	-51	-0.070300427
2358	8/7/2014	5	941	1050	-109	-0.116896482
2359	8/7/2014	6	1172	1171	1	0.00054205
2360	8/7/2014	7	1215	1242	-27	-0.022463086
2361	8/7/2014	8	1185	1207	-22	-0.019195655
2362	8/7/2014	9	1177	1270	-93	-0.07956678
2363	8/7/2014	10	1207	1180	27	0.021646828
2364	8/7/2014	11	1140	1213	-73	-0.064718575
2365	8/7/2014	12	1018	1129	-111	-0.109449891
2366	8/7/2014	13	1119	1042	77	0.068260411
2367	8/7/2014	14	974	1125	-151	-0.155382866
2368	8/7/2014	15	1102	1098	4	0.003413668
2369	8/7/2014	16	1083	1147	-64	-0.059117357
2370	8/7/2014	17	1083	1112	-29	-0.027424639
2371	8/7/2014	18	766	880	-114	-0.148949922
2372	8/7/2014	19	446	474	-28	-0.062991439
2373	8/7/2014	20	261	229	32	0.122389603
2374	8/7/2014	21	132	135	-3	-0.029104329
2375	8/7/2014	22	73	79	-6	-0.086275399
2376	8/7/2014	23	62	51	11	0.173927791
2377	8/8/2014	0	71	80	-9	-0.131338875
2378	8/8/2014	1	147	171	-24	-0.167022805
2379	8/8/2014	2	303	251	52	0.171598283
2380	8/8/2014	3	467	490	-23	-0.049527964
2381	8/8/2014	4	695	735	-40	-0.058070893
2382	8/8/2014	5	838	972	-134	-0.160417153
2383	8/8/2014	6	1114	1060	54	0.047928409
2384	8/8/2014	7	1089	1163	-74	-0.068438223
2385	8/8/2014	8	961	1105	-144	-0.15054973
2386	8/8/2014	9	1169	1094	75	0.063538644
2387	8/8/2014	10	1181	1194	-13	-0.011442883
2388	8/8/2014	11	1120	1183	-63	-0.056376223
2389	8/8/2014	12	1103	1057	46	0.041486559
2390	8/8/2014	13	1069	1101	-32	-0.030630414
2391	8/8/2014	14	954	1032	-78	-0.08192028
2392	8/8/2014	15	1074	1090	-16	-0.014900935
2393	8/8/2014	16	1069	1117	-48	-0.045089956
2394	8/8/2014	17	1069	1117	-48	-0.045745933
2395	8/8/2014	18	830	814	16	0.01869412
2396	8/8/2014	19	392	500	-108	-0.277780921
2397	8/8/2014	20	243	217	26	0.106812406
2398	8/8/2014	21	131	128	3	0.020490637
2399	8/8/2014	22	68	77	-9	-0.146191513
2400	8/8/2014	23	43	54	-11	-0.256813131
2401	8/9/2014	0	64	57	7	0.106266508
2402	8/9/2014	1	138	147	-9	-0.071353083
2403	8/9/2014	2	258	266	-8	-0.031272051
2404	8/9/2014	3	412	425	-13	-0.033976895
2405	8/9/2014	4	587	632	-45	-0.077005448
2406	8/9/2014	5	905	814	91	0.100304006
2407	8/9/2014	6	1134	1132	2	0.001101867
2408	8/9/2014	7	1259	1152	107	0.084602037
2409	8/9/2014	8	1055	1178	-123	-0.117094769
2410	8/9/2014	9	956	1159	-203	-0.212707772
2411	8/9/2014	10	1082	1020	62	0.057004038
2412	8/9/2014	11	956	1103	-147	-0.153928218
2413	8/9/2014	12	931	955	-24	-0.026606635
2414	8/9/2014	13	857	993	-136	-0.158779452
2415	8/9/2014	14	905	848	57	0.062287529
2416	8/9/2014	15	909	1029	-120	-0.132076549
2417	8/9/2014	16	1023	968	55	0.05343156
2418	8/9/2014	17	931	1059	-128	-0.138174211
2419	8/9/2014	18	659	700	-41	-0.062643329
2420	8/9/2014	19	411	394	17	0.041181485
2421	8/9/2014	20	224	228	-4	-0.021771688
2422	8/9/2014	21	113	120	-7	-0.062377551
2423	8/9/2014	22	71	67	4	0.053419056
2424	8/9/2014	23	46	49	-3	-0.08125527
2425	8/10/2014	0	53	65	-12	-0.240162671
2426	8/10/2014	1	120	122	-2	-0.023852409
2427	8/10/2014	2	221	237	-16	-0.073170773
2428	8/10/2014	3	413	380	33	0.077507143
2429	8/10/2014	4	553	618	-65	-0.118469709
2430	8/10/2014	5	768	774	-6	-0.00812794
2431	8/10/2014	6	956	995	-39	-0.041579824
2432	8/10/2014	7	1015	1030	-15	-0.015305353
2433	8/10/2014	8	863	946	-83	-0.096552458
2434	8/10/2014	9	775	946	-171	-0.220755472
2435	8/10/2014	10	848	868	-20	-0.023990833
2436	8/10/2014	11	870	869	1	0.001100188
2437	8/10/2014	12	841	882	-41	-0.049742282
2438	8/10/2014	13	894	876	18	0.019628927
2439	8/10/2014	14	1009	862	147	0.145578154
2440	8/10/2014	15	1026	1078	-52	-0.051497953
2441	8/10/2014	16	1046	1035	11	0.010419314
2442	8/10/2014	17	946	1002	-56	-0.059870895
2443	8/10/2014	18	731	705	26	0.034475377
2444	8/10/2014	19	388	421	-33	-0.087223768
2445	8/10/2014	20	186	226	-40	-0.215900747
2446	8/10/2014	21	84	101	-17	-0.208179739
2447	8/10/2014	22	46	54	-8	-0.188352517
2448	8/10/2014	23	33	36	-3	-0.09523317
2449	8/11/2014	0	50	48	2	0.039071696
2450	8/11/2014	1	112	114	-2	-0.018860888
2451	8/11/2014	2	194	218	-24	-0.124937335
2452	8/11/2014	3	363	345	18	0.049311962
2453	8/11/2014	4	619	528	91	0.146067597
2454	8/11/2014	5	924	833	91	0.098146241
2455	8/11/2014	6	1080	1130	-50	-0.046580495
2456	8/11/2014	7	1064	1096	-32	-0.0305739
2457	8/11/2014	8	1011	937	74	0.072392863
2458	8/11/2014	9	1115	1011	104	0.092573613
2459	8/11/2014	10	1112	1178	-66	-0.05976598
2460	8/11/2014	11	1201	1039	162	0.134630004
2461	8/11/2014	12	1174	1098	76	0.06469587
2462	8/11/2014	13	1003	1150	-147	-0.147394282
2463	8/11/2014	14	1037	982	55	0.052767192
2464	8/11/2014	15	1093	1074	19	0.016721269
2465	8/11/2014	16	1150	1139	11	0.009426442
2466	8/11/2014	17	1117	1092	25	0.022243857
2467	8/11/2014	18	782	801	-19	-0.024754625
2468	8/11/2014	19	439	433	6	0.013515166
2469	8/11/2014	20	182	242	-60	-0.333971632
2470	8/11/2014	21	106	95	11	0.099058917
2471	8/11/2014	22	54	60	-6	-0.129629083
2472	8/11/2014	23	54	41	13	0.240295396
2473	8/12/2014	0	64	69	-5	-0.09324344
2474	8/12/2014	1	167	137	30	0.178015997
2475	8/12/2014	2	270	290	-20	-0.077243572
2476	8/12/2014	3	446	448	-2	-0.005264205
2477	8/12/2014	4	631	661	-30	-0.048131491
2478	8/12/2014	5	858	893	-35	-0.041083046
2479	8/12/2014	6	947	1111	-164	-0.173639932
2480	8/12/2014	7	1147	1040	107	0.092896797
2481	8/12/2014	8	360	1018	-658	-1.829629737
2482	8/12/2014	9	877	471	406	0.462406294
2483	8/12/2014	10	1293	982	311	0.240018343
2484	8/12/2014	11	1062	1303	-241	-0.227205734
2485	8/12/2014	12	1141	1024	117	0.10190875
2486	8/12/2014	13	1011	953	58	0.056897626
2487	8/12/2014	14	1138	1039	99	0.086619269
2488	8/12/2014	15	1070	1167	-97	-0.0915119
2489	8/12/2014	16	1217	1105	112	0.091653794
2490	8/12/2014	17	1146	1119	27	0.023137325
2491	8/12/2014	18	819	858	-39	-0.048382397
2492	8/12/2014	19	471	442	29	0.061193149
2493	8/12/2014	20	234	229	5	0.020916882
2494	8/12/2014	21	129	120	9	0.064172405
2495	8/12/2014	22	52	69	-17	-0.336134372
2496	8/12/2014	23	44	39	5	0.097350754
2497	8/13/2014	0	69	58	11	0.151621293
2498	8/13/2014	1	141	157	-16	-0.113966494
2499	8/13/2014	2	274	253	21	0.075475372
2500	8/13/2014	3	385	439	-54	-0.142797242
2501	8/13/2014	4	506	574	-68	-0.135765737
2502	8/13/2014	5	873	795	78	0.089075103
2503	8/13/2014	6	1074	1045	29	0.026601013
2504	8/13/2014	7	1111	1155	-44	-0.040118042
2505	8/13/2014	8	1081	767	314	0.289657352
2506	8/13/2014	9	1103	1224	-121	-0.110496566
2507	8/13/2014	10	1201	1222	-21	-0.018054077
2508	8/13/2014	11	1089	1127	-38	-0.03500912
2509	8/13/2014	12	1146	1069	77	0.066488539
2510	8/13/2014	13	1023	1062	-39	-0.038462606
2511	8/13/2014	14	1022	1106	-84	-0.083067027
2512	8/13/2014	15	1086	1046	40	0.036607174
2513	8/13/2014	16	1098	1201	-103	-0.094345109
2514	8/13/2014	17	972	1056	-84	-0.087153969
2515	8/13/2014	18	729	710	19	0.025620035
2516	8/13/2014	19	393	428	-35	-0.090427528
2517	8/13/2014	20	115	197	-82	-0.720954338
2518	8/13/2014	21	70	68	2	0.017976982
2519	8/13/2014	22	34	39	-5	-0.173683951
2520	8/13/2014	23	32	31	1	0.006593657
2521	8/14/2014	0	87	47	40	0.452322933
2522	8/14/2014	1	141	182	-41	-0.293597829
2523	8/14/2014	2	266	238	28	0.102805089
2524	8/14/2014	3	416	419	-3	-0.008803696
2525	8/14/2014	4	679	584	95	0.139097125
2526	8/14/2014	5	880	972	-92	-0.105599507
2527	8/14/2014	6	1142	1046	96	0.08383747
2528	8/14/2014	7	1151	1244	-93	-0.08102037
2529	8/14/2014	8	1075	784	291	0.270417578
2530	8/14/2014	9	1129	1286	-157	-0.139124571
2531	8/14/2014	10	1196	1276	-80	-0.067406092
2532	8/14/2014	11	1060	1087	-27	-0.025704622
2533	8/14/2014	12	1012	1092	-80	-0.079932502
2534	8/14/2014	13	864	980	-116	-0.135067268
2535	8/14/2014	14	846	983	-137	-0.162206213
2536	8/14/2014	15	808	904	-96	-0.118902551
2537	8/14/2014	16	853	919	-66	-0.078520676
2538	8/14/2014	17	871	859	12	0.012849058
2539	8/14/2014	18	698	672	26	0.037182514
2540	8/14/2014	19	403	397	6	0.014755586
2541	8/14/2014	20	203	165	38	0.182387951
2542	8/14/2014	21	97	104	-7	-0.078580359
2543	8/14/2014	22	52	46	6	0.114650062
2544	8/14/2014	23	53	44	9	0.156741538
2545	8/15/2014	0	53	82	-29	-0.558148985
2546	8/15/2014	1	107	117	-10	-0.098563384
2547	8/15/2014	2	254	204	50	0.194449355
2548	8/15/2014	3	355	416	-61	-0.172873455
2549	8/15/2014	4	580	575	5	0.007314366
2550	8/15/2014	5	681	860	-179	-0.264096906
2551	8/15/2014	6	875	867	8	0.008936558
2552	8/15/2014	7	965	968	-3	-0.003322292
2553	8/15/2014	8	828	738	90	0.108026273
2554	8/15/2014	9	626	1067	-441	-0.705392505
2555	8/15/2014	10	1003	792	211	0.209433937
2556	8/15/2014	11	898	958	-60	-0.067267187
2557	8/15/2014	12	805	974	-169	-0.211139062
2558	8/15/2014	13	802	763	39	0.047958592
2559	8/15/2014	14	896	835	61	0.067593941
2560	8/15/2014	15	843	951	-108	-0.128748702
2561	8/15/2014	16	894	931	-37	-0.041648733
2562	8/15/2014	17	804	861	-57	-0.07186122
2563	8/15/2014	18	720	640	80	0.110347624
2564	8/15/2014	19	437	410	27	0.060152991
2565	8/15/2014	20	204	176	28	0.133021193
2566	8/15/2014	21	117	109	8	0.06796574
2567	8/15/2014	22	56	53	3	0.049619099
2568	8/15/2014	23	47	49	-2	-0.046189763
2569	8/16/2014	0	46	70	-24	-0.527882838
2570	8/16/2014	1	103	102	1	0.009222819
2571	8/16/2014	2	244	216	28	0.112406691
2572	8/16/2014	3	391	405	-14	-0.037765424
2573	8/16/2014	4	526	592	-66	-0.126542508
2574	8/16/2014	5	821	709	112	0.135399022
2575	8/16/2014	6	993	1006	-13	-0.013690976
2576	8/16/2014	7	1084	1083	1	0.000142665
2577	8/16/2014	8	1018	768	250	0.245318796
2578	8/16/2014	9	1080	1120	-40	-0.037282224
2579	8/16/2014	10	935	1332	-397	-0.425471577
2580	8/16/2014	11	1003	843	160	0.158903068
2581	8/16/2014	12	904	1008	-104	-0.116040211
2582	8/16/2014	13	922	883	39	0.041216872
2583	8/16/2014	14	939	995	-56	-0.059998585
2584	8/16/2014	15	1031	907	124	0.119809509
2585	8/16/2014	16	939	1079	-140	-0.150126445
2586	8/16/2014	17	948	903	45	0.046519523
2587	8/16/2014	18	653	744	-91	-0.140171246
2588	8/16/2014	19	401	386	15	0.034943055
2589	8/16/2014	20	199	180	19	0.091090168
2590	8/16/2014	21	92	108	-16	-0.178301559
2591	8/16/2014	22	45	45	0	-0.002517924
2592	8/16/2014	23	31	41	-10	-0.338814487
2593	8/17/2014	0	49	47	2	0.023056951
2594	8/17/2014	1	104	104	0	-0.006233177
2595	8/17/2014	2	233	236	-3	-0.015913779
2596	8/17/2014	3	393	359	34	0.085310974
2597	8/17/2014	4	573	585	-12	-0.021312558
2598	8/17/2014	5	777	799	-22	-0.028726663
2599	8/17/2014	6	930	965	-35	-0.038117002
2600	8/17/2014	7	1044	1013	31	0.029341508
2601	8/17/2014	8	908	988	-80	-0.088460189
2602	8/17/2014	9	870	886	-16	-0.018749818
2603	8/17/2014	10	884	1021	-137	-0.155077898
2604	8/17/2014	11	811	867	-56	-0.070250409
2605	8/17/2014	12	898	815	83	0.092061134
2606	8/17/2014	13	829	872	-43	-0.052288806
2607	8/17/2014	14	945	872	73	0.076886694
2608	8/17/2014	15	973	949	24	0.023935638
2609	8/17/2014	16	957	959	-2	-0.00265093
2610	8/17/2014	17	895	895	0	-0.000554694
2611	8/17/2014	18	670	692	-22	-0.03428897
2612	8/17/2014	19	425	401	24	0.055708855
2613	8/17/2014	20	205	183	22	0.105609935
2614	8/17/2014	21	105	105	0	-0.008290859
2615	8/17/2014	22	43	50	-7	-0.178923101
2616	8/17/2014	23	36	37	-1	-0.03454241
2617	8/18/2014	0	56	52	4	0.069275814
2618	8/18/2014	1	82	114	-32	-0.394423982
2619	8/18/2014	2	214	201	13	0.059393534
2620	8/18/2014	3	327	347	-20	-0.06232176
2621	8/18/2014	4	645	515	130	0.200180396
2622	8/18/2014	5	828	862	-34	-0.042160588
2623	8/18/2014	6	917	1002	-85	-0.09290855
2624	8/18/2014	7	1087	990	97	0.089229684
2625	8/18/2014	8	1058	963	95	0.08935805
2626	8/18/2014	9	1152	1006	146	0.126692405
2627	8/18/2014	10	1201	1188	13	0.010411034
2628	8/18/2014	11	953	1085	-132	-0.138913022
2629	8/18/2014	12	1112	914	198	0.177703224
2630	8/18/2014	13	995	1017	-22	-0.022675451
2631	8/18/2014	14	972	1057	-85	-0.088173058
2632	8/18/2014	15	984	970	14	0.013778559
2633	8/18/2014	16	1076	980	96	0.089071434
2634	8/18/2014	17	1049	1031	18	0.017043125
2635	8/18/2014	18	774	797	-23	-0.030088183
2636	8/18/2014	19	384	464	-80	-0.208838729
2637	8/18/2014	20	210	192	18	0.082733701
2638	8/18/2014	21	109	107	2	0.014800673
2639	8/18/2014	22	69	52	17	0.237347379
2640	8/18/2014	23	51	53	-2	-0.0571557
2641	8/19/2014	0	61	60	1	5.42E-05
2642	8/19/2014	1	127	113	14	0.107054435
2643	8/19/2014	2	263	287	-24	-0.09246133
2644	8/19/2014	3	420	412	8	0.017115945
2645	8/19/2014	4	608	668	-60	-0.099361575
2646	8/19/2014	5	830	829	1	0.00049479
2647	8/19/2014	6	1086	1008	78	0.071258222
2648	8/19/2014	7	1117	1211	-94	-0.084636909
2649	8/19/2014	8	1103	1033	70	0.063063217
2650	8/19/2014	9	1151	1036	115	0.099871502
2651	8/19/2014	10	1200	1224	-24	-0.020217648
2652	8/19/2014	11	1079	1068	11	0.009592611
2653	8/19/2014	12	1000	1054	-54	-0.054802627
2654	8/19/2014	13	965	958	7	0.007236096
2655	8/19/2014	14	1048	1028	20	0.018184326
2656	8/19/2014	15	1035	1075	-40	-0.038882139
2657	8/19/2014	16	1149	1044	105	0.090772914
2658	8/19/2014	17	1109	1082	27	0.023841006
2659	8/19/2014	18	965	826	139	0.143049944
2660	8/19/2014	19	461	525	-64	-0.140824538
2661	8/19/2014	20	220	225	-5	-0.026119724
2662	8/19/2014	21	105	113	-8	-0.078770759
2663	8/19/2014	22	74	53	21	0.272543339
2664	8/19/2014	23	44	54	-10	-0.249480437
2665	8/20/2014	0	60	57	3	0.03767482
2666	8/20/2014	1	142	111	31	0.213211931
2667	8/20/2014	2	296	311	-15	-0.053384838
2668	8/20/2014	3	399	465	-66	-0.167611913
2669	8/20/2014	4	685	605	80	0.115950233
2670	8/20/2014	5	931	930	1	0.000652023
2671	8/20/2014	6	1120	1134	-14	-0.012744728
2672	8/20/2014	7	1128	1228	-100	-0.089376555
2673	8/20/2014	8	1076	1057	19	0.017611548
2674	8/20/2014	9	1057	1131	-74	-0.070819075
2675	8/20/2014	10	1148	1079	69	0.060071212
2676	8/20/2014	11	1154	1040	114	0.098190613
2677	8/20/2014	12	1082	1151	-69	-0.063796149
2678	8/20/2014	13	1036	1021	15	0.013783335
2679	8/20/2014	14	917	1065	-148	-0.161937153
2680	8/20/2014	15	1036	970	66	0.063284767
2681	8/20/2014	16	1075	1080	-5	-0.005184769
2682	8/20/2014	17	1041	1069	-28	-0.027181699
2683	8/20/2014	18	829	796	33	0.039344224
2684	8/20/2014	19	422	446	-24	-0.057396021
2685	8/20/2014	20	254	215	39	0.152192503
2686	8/20/2014	21	100	121	-21	-0.213529262
2687	8/20/2014	22	57	55	2	0.025552904
2688	8/20/2014	23	32	40	-8	-0.278612918
2689	8/21/2014	0	54	48	6	0.096754186
2690	8/21/2014	1	106	111	-5	-0.050113195
2691	8/21/2014	2	197	243	-46	-0.238109899
2692	8/21/2014	3	357	324	33	0.09027961
2693	8/21/2014	4	564	591	-27	-0.048789043
2694	8/21/2014	5	784	793	-9	-0.011777872
2695	8/21/2014	6	944	968	-24	-0.026102667
2696	8/21/2014	7	1056	1024	32	0.029510075
2697	8/21/2014	8	913	1020	-107	-0.117507772
2698	8/21/2014	9	972	953	19	0.018928903
2699	8/21/2014	10	1000	1041	-41	-0.041258266
2700	8/21/2014	11	965	934	31	0.031477907
2701	8/21/2014	12	890	1008	-118	-0.133433643
2702	8/21/2014	13	833	853	-20	-0.024680621
2703	8/21/2014	14	852	867	-15	-0.018708767
2704	8/21/2014	15	927	926	1	0.000908968
2705	8/21/2014	16	1015	1008	7	0.006313897
2706	8/21/2014	17	1061	985	76	0.070707172
2707	8/21/2014	18	777	824	-47	-0.06069368
2708	8/21/2014	19	428	410	18	0.040877296
2709	8/21/2014	20	220	222	-2	-0.009278657
2710	8/21/2014	21	121	103	18	0.148232619
2711	8/21/2014	22	62	67	-5	-0.096211252
2712	8/21/2014	23	52	41	11	0.211078853
2713	8/22/2014	0	55	69	-14	-0.268571188
2714	8/22/2014	1	138	109	29	0.208788222
2715	8/22/2014	2	275	285	-10	-0.03843635
2716	8/22/2014	3	377	416	-39	-0.105495968
2717	8/22/2014	4	606	635	-29	-0.048241183
2718	8/22/2014	5	373	825	-452	-1.212615495
2719	8/22/2014	6	1105	558	547	0.49421561
2720	8/22/2014	7	1102	1208	-106	-0.096360483
2721	8/22/2014	8	1005	1094	-89	-0.08903581
2722	8/22/2014	9	1089	1045	44	0.04022839
2723	8/22/2014	10	1012	1079	-67	-0.066272376
2724	8/22/2014	11	1044	977	67	0.064146691
2725	8/22/2014	12	1004	1019	-15	-0.015867921
2726	8/22/2014	13	913	951	-38	-0.041980786
2727	8/22/2014	14	1006	919	87	0.085607676
2728	8/22/2014	15	999	1055	-56	-0.056105888
2729	8/22/2014	16	1085	1104	-19	-0.018247911
2730	8/22/2014	17	988	1064	-76	-0.077347271
2731	8/22/2014	18	726	808	-82	-0.113280364
2732	8/22/2014	19	439	384	55	0.125024174
2733	8/22/2014	20	208	237	-29	-0.141128668
2734	8/22/2014	21	122	104	18	0.143674101
2735	8/22/2014	22	84	71	13	0.154054891
2736	8/22/2014	23	44	54	-10	-0.227570725
2737	8/23/2014	0	70	56	14	0.192854659
2738	8/23/2014	1	138	147	-9	-0.068673038
2739	8/23/2014	2	250	276	-26	-0.106031661
2740	8/23/2014	3	408	390	18	0.042764373
2741	8/23/2014	4	624	633	-9	-0.015697578
2742	8/23/2014	5	963	722	241	0.249708976
2743	8/23/2014	6	1105	1394	-289	-0.261780335
2744	8/23/2014	7	1260	1150	110	0.086707704
2745	8/23/2014	8	1182	1145	37	0.030663722
2746	8/23/2014	9	1115	1194	-79	-0.070975207
2747	8/23/2014	10	1206	1151	55	0.0449121
2748	8/23/2014	11	1126	1143	-17	-0.015919247
2749	8/23/2014	12	1054	1071	-17	-0.016724855
2750	8/23/2014	13	990	1004	-14	-0.014232191
2751	8/23/2014	14	968	1012	-44	-0.046211043
2752	8/23/2014	15	1016	1021	-5	-0.005629339
2753	8/23/2014	16	955	1104	-149	-0.156278763
2754	8/23/2014	17	1025	987	38	0.036645729
2755	8/23/2014	18	693	800	-107	-0.154842293
2756	8/23/2014	19	385	395	-10	-0.02842434
2757	8/23/2014	20	206	209	-3	-0.014863848
2758	8/23/2014	21	111	105	6	0.047818219
2759	8/23/2014	22	54	68	-14	-0.273447254
2760	8/23/2014	23	47	35	12	0.246568344
2761	8/24/2014	0	44	65	-21	-0.486469144
2762	8/24/2014	1	96	103	-7	-0.081234972
2763	8/24/2014	2	235	199	36	0.151611889
2764	8/24/2014	3	367	369	-2	-0.006387091
2765	8/24/2014	4	666	625	41	0.060635429
2766	8/24/2014	5	855	726	129	0.150860489
2767	8/24/2014	6	1022	1227	-205	-0.20118324
2768	8/24/2014	7	1124	1089	35	0.030377587
2769	8/24/2014	8	1026	1003	23	0.022158142
2770	8/24/2014	9	1047	1075	-28	-0.027008958
2771	8/24/2014	10	903	1105	-202	-0.224411691
2772	8/24/2014	11	935	935	0	-0.000584784
2773	8/24/2014	12	883	914	-31	-0.035550607
2774	8/24/2014	13	886	861	25	0.027751615
2775	8/24/2014	14	1008	904	104	0.102753879
2776	8/24/2014	15	989	1047	-58	-0.0588757
2777	8/24/2014	16	1020	1032	-12	-0.012589982
2778	8/24/2014	17	1026	984	42	0.040285395
2779	8/24/2014	18	726	765	-39	-0.054669833
2780	8/24/2014	19	435	409	26	0.057675239
2781	8/24/2014	20	188	223	-35	-0.190934382
2782	8/24/2014	21	96	102	-6	-0.064838438
2783	8/24/2014	22	51	56	-5	-0.116487755
2784	8/24/2014	23	40	36	4	0.080188073
2785	8/25/2014	0	54	52	2	0.023770101
2786	8/25/2014	1	141	118	23	0.163012888
2787	8/25/2014	2	247	268	-21	-0.088867241
2788	8/25/2014	3	408	387	21	0.050183547
2789	8/25/2014	4	725	645	80	0.110002756
2790	8/25/2014	5	920	799	121	0.131483458
2791	8/25/2014	6	1092	1290	-198	-0.181621235
2792	8/25/2014	7	1104	1173	-69	-0.063073577
2793	8/25/2014	8	1146	1020	126	0.109558841
2794	8/25/2014	9	1143	1181	-38	-0.033875596
2795	8/25/2014	10	1202	1131	71	0.059036658
2796	8/25/2014	11	1130	1145	-15	-0.013636068
2797	8/25/2014	12	1147	1046	101	0.087321092
2798	8/25/2014	13	1012	1067	-55	-0.054903026
2799	8/25/2014	14	1093	1058	35	0.031171507
2800	8/25/2014	15	1159	1098	61	0.052045507
2801	8/25/2014	16	1288	1161	127	0.098263025
2802	8/25/2014	17	1131	1269	-138	-0.122838385
2803	8/25/2014	18	851	789	62	0.072400715
2804	8/25/2014	19	450	480	-30	-0.066829468
2805	8/25/2014	20	208	225	-17	-0.08618221
2806	8/25/2014	21	119	115	4	0.032627849
2807	8/25/2014	22	65	64	1	0.002094945
2808	8/25/2014	23	50	49	1	0.008558249
2809	8/26/2014	0	65	60	5	0.061546203
2810	8/26/2014	1	169	144	25	0.143937694
2811	8/26/2014	2	297	318	-21	-0.0734997
2812	8/26/2014	3	458	446	12	0.024641398
2813	8/26/2014	4	712	747	-35	-0.050118652
2814	8/26/2014	5	988	813	175	0.176677071
2815	8/26/2014	6	1130	1396	-266	-0.236222921
2816	8/26/2014	7	1144	1220	-76	-0.066496619
2817	8/26/2014	8	1109	1092	17	0.014653236
2818	8/26/2014	9	1237	1149	88	0.071061176
2819	8/26/2014	10	1176	1229	-53	-0.045700466
2820	8/26/2014	11	1179	1159	20	0.016709969
2821	8/26/2014	12	1202	1108	94	0.077827397
2822	8/26/2014	13	1037	1088	-51	-0.049856006
2823	8/26/2014	14	1232	1111	121	0.097521445
2824	8/26/2014	15	1181	1213	-32	-0.027574007
2825	8/26/2014	16	1385	1221	164	0.118268771
2826	8/26/2014	17	1268	1283	-15	-0.012239492
2827	8/26/2014	18	834	881	-47	-0.057114259
2828	8/26/2014	19	498	469	29	0.057447643
2829	8/26/2014	20	254	230	24	0.09401263
2830	8/26/2014	21	135	137	-2	-0.015687111
2831	8/26/2014	22	81	73	8	0.090847336
2832	8/26/2014	23	45	55	-10	-0.23594774
2833	8/27/2014	0	88	58	30	0.339517646
2834	8/27/2014	1	167	191	-24	-0.143763369
2835	8/27/2014	2	291	311	-20	-0.070778236
2836	8/27/2014	3	490	453	37	0.074239552
2837	8/27/2014	4	781	794	-13	-0.016672998
2838	8/27/2014	5	1093	1076	17	0.015185835
2839	8/27/2014	6	1120	1250	-130	-0.116874541
2840	8/27/2014	7	1147	1204	-57	-0.049707549
2841	8/27/2014	8	1080	1137	-57	-0.053455602
2842	8/27/2014	9	1177	1144	33	0.027444591
2843	8/27/2014	10	1221	1178	43	0.034662194
2844	8/27/2014	11	1199	1185	14	0.010978748
2845	8/27/2014	12	2723	1172	1551	0.569530231
2846	8/27/2014	13	2786	2029	757	0.271565574
2847	8/27/2014	14	2987	2396	591	0.19774803
2848	8/27/2014	15	3105	2294	811	0.261115719
2849	8/27/2014	16	3407	2497	910	0.266942306
2850	8/27/2014	17	3209	2668	541	0.168399723
2851	8/27/2014	18	2364	1813	551	0.233074118
2852	8/27/2014	19	1525	1097	428	0.280144126
2853	8/27/2014	20	782	593	189	0.240766179
2854	8/27/2014	21	450	332	118	0.260586748
2855	8/27/2014	22	216	185	31	0.139146961
2856	8/27/2014	23	152	126	26	0.168649205
2857	8/28/2014	0	253	166	87	0.341506215
2858	8/28/2014	1	451	454	-3	-0.007574222
2859	8/28/2014	2	789	715	74	0.092656521
2860	8/28/2014	3	1384	1052	332	0.239798623
2861	8/28/2014	4	2082	1947	135	0.064817912
2862	8/28/2014	5	2782	2457	325	0.116700146
2863	8/28/2014	6	3296	2655	641	0.194396068
2864	8/28/2014	7	3242	2930	312	0.096167101
2865	8/28/2014	8	2541	2747	-206	-0.081222015
2866	8/28/2014	9	2702	2399	303	0.111780947
2867	8/28/2014	10	3353	2377	976	0.290955635
2868	8/28/2014	11	3411	2956	455	0.133132
2869	8/28/2014	12	2889	3599	-710	-0.246057063
2870	8/28/2014	13	2868	2459	409	0.142598306
2871	8/28/2014	14	2814	2938	-124	-0.044077894
2872	8/28/2014	15	3038	2723	315	0.103403578
2873	8/28/2014	16	3180	3168	12	0.003613382
2874	8/28/2014	17	3259	2767	492	0.150749773
2875	8/28/2014	18	2458	2157	301	0.122411286
2876	8/28/2014	19	1278	1321	-43	-0.034289399
2877	8/28/2014	20	642	558	84	0.130095287
2878	8/28/2014	21	445	311	134	0.30064636
2879	8/28/2014	22	230	209	21	0.089959695
2880	8/28/2014	23	193	137	56	0.286950157
2881	8/29/2014	0	155	239	-84	-0.547951768
2882	8/29/2014	1	178	322	-144	-0.81005544
2883	8/29/2014	2	687	349	338	0.491392121
2884	8/29/2014	3	1007	1096	-89	-0.089281209
2885	8/29/2014	4	1624	1650	-26	-0.01613665
2886	8/29/2014	5	2050	2017	33	0.015889601
2887	8/29/2014	6	2858	2126	732	0.255833307
2888	8/29/2014	7	3110	2595	515	0.165336667
2889	8/29/2014	8	2543	2488	55	0.021541524
2890	8/29/2014	9	2587	2394	193	0.074578668
2891	8/29/2014	10	2809	2469	340	0.120766713
2892	8/29/2014	11	2903	2523	380	0.130559863
2893	8/29/2014	12	2746	3175	-429	-0.156351192
2894	8/29/2014	13	2712	2417	295	0.108750142
2895	8/29/2014	14	2704	2713	-9	-0.003513782
2896	8/29/2014	15	2758	2737	21	0.007363514
2897	8/29/2014	16	2938	2971	-33	-0.011277511
2898	8/29/2014	17	2653	2642	11	0.003850628
2899	8/29/2014	18	2207	1877	330	0.149490512
2900	8/29/2014	19	1298	1178	120	0.091729585
2901	8/29/2014	20	714	582	132	0.184601475
2902	8/29/2014	21	452	386	66	0.144837096
2903	8/29/2014	22	239	215	24	0.097720406
2904	8/29/2014	23	162	148	14	0.083900599
2905	8/30/2014	0	174	193	-19	-0.114321354
2906	8/30/2014	1	367	294	73	0.197261585
2907	8/30/2014	2	788	723	65	0.08240833
2908	8/30/2014	3	1185	1215	-30	-0.026093291
2909	8/30/2014	4	1831	1781	50	0.02729744
2910	8/30/2014	5	2599	2263	336	0.129126793
2911	8/30/2014	6	3027	2863	164	0.054043006
2912	8/30/2014	7	2973	2919	54	0.017954444
2913	8/30/2014	8	2523	2459	64	0.025247103
2914	8/30/2014	9	2659	2574	85	0.031915369
2915	8/30/2014	10	2972	2761	211	0.07080447
2916	8/30/2014	11	2865	2860	5	0.001420092
2917	8/30/2014	12	2667	3179	-512	-0.192044234
2918	8/30/2014	13	2708	2628	80	0.029497562
2919	8/30/2014	14	2635	2860	-225	-0.085696257
2920	8/30/2014	15	2716	2780	-64	-0.023845038
2921	8/30/2014	16	2682	3016	-334	-0.124554158
2922	8/30/2014	17	2814	2643	171	0.060696326
2923	8/30/2014	18	2235	2132	103	0.045899062
2924	8/30/2014	19	1339	1296	43	0.031411034
2925	8/30/2014	20	754	695	59	0.077054716
2926	8/30/2014	21	466	432	34	0.070982085
2927	8/30/2014	22	290	231	59	0.200340256
2928	8/30/2014	23	161	184	-23	-0.143772177
2929	8/31/2014	0	194	198	-4	-0.022846532
2930	8/31/2014	1	354	316	38	0.106789913
2931	8/31/2014	2	691	793	-102	-0.148548767
2932	8/31/2014	3	1155	1117	38	0.032527536
2933	8/31/2014	4	1789	1749	40	0.022333639
2934	8/31/2014	5	2420	2417	3	0.001107307
2935	8/31/2014	6	2955	2898	57	0.019152536
2936	8/31/2014	7	3189	2915	274	0.085613157
2937	8/31/2014	8	2534	2565	-31	-0.012462161
2938	8/31/2014	9	2366	2592	-226	-0.095649317
2939	8/31/2014	10	2736	2638	98	0.035525716
2940	8/31/2014	11	2718	2696	22	0.00794439
2941	8/31/2014	12	2753	3068	-315	-0.114455039
2942	8/31/2014	13	2726	2800	-74	-0.027300985
2943	8/31/2014	14	2999	2766	233	0.077548564
2944	8/31/2014	15	3022	3158	-136	-0.045218551
2945	8/31/2014	16	3134	3200	-66	-0.021233446
2946	8/31/2014	17	2946	3051	-105	-0.035826343
2947	8/31/2014	18	2033	2305	-272	-0.134144814
2948	8/31/2014	19	1216	1243	-27	-0.02268817
2949	8/31/2014	20	625	666	-41	-0.066689576
2950	8/31/2014	21	313	415	-102	-0.327572968
2951	8/31/2014	22	205	185	20	0.092879131
2952	8/31/2014	23	111	147	-36	-0.328745562
2953	9/1/2014	0	149	141	8	0.053365703
2954	9/1/2014	1	372	264	108	0.288292053
2955	9/1/2014	2	635	828	-193	-0.30431484
2956	9/1/2014	3	993	1049	-56	-0.056505997
2957	9/1/2014	4	1703	1539	164	0.096197819
2958	9/1/2014	5	2387	2309	78	0.032326693
2959	9/1/2014	6	3022	3030	-8	-0.002728607
2960	9/1/2014	7	2848	3085	-237	-0.083338589
2961	9/1/2014	8	2362	2342	20	0.008071096
2962	9/1/2014	9	2785	2461	324	0.116119547
2963	9/1/2014	10	2988	3170	-182	-0.061237094
2964	9/1/2014	11	3232	2991	241	0.074437342
2965	9/1/2014	12	2894	2944	-50	-0.01739057
2966	9/1/2014	13	2717	2874	-157	-0.057947193
2967	9/1/2014	14	2910	2772	138	0.047400198
2968	9/1/2014	15	3008	2982	26	0.008393509
2969	9/1/2014	16	3250	3088	162	0.049781374
2970	9/1/2014	17	3129	3144	-15	-0.00511021
2971	9/1/2014	18	2351	2360	-9	-0.004028224
2972	9/1/2014	19	1247	1332	-85	-0.068466582
2973	9/1/2014	20	738	686	52	0.069753203
2974	9/1/2014	21	363	445	-82	-0.228052787
2975	9/1/2014	22	224	216	8	0.032501004
2976	9/1/2014	23	164	146	18	0.103977701
2977	9/2/2014	0	237	183	54	0.225825119
2978	9/2/2014	1	454	410	44	0.095631349
2979	9/2/2014	2	775	930	-155	-0.200899591
2980	9/2/2014	3	1359	1147	212	0.155878314
2981	9/2/2014	4	1976	2057	-81	-0.041494914
2982	9/2/2014	5	2774	2725	49	0.017418413
2983	9/2/2014	6	3214	3470	-256	-0.079748844
2984	9/2/2014	7	3546	3288	258	0.072521619
2985	9/2/2014	8	2574	2905	-331	-0.12861876
2986	9/2/2014	9	2823	2711	112	0.039352096
2987	9/2/2014	10	3176	3146	30	0.009374995
2988	9/2/2014	11	2943	3237	-294	-0.099898566
2989	9/2/2014	12	2639	2843	-204	-0.077674422
2990	9/2/2014	13	2401	2646	-245	-0.102085784
2991	9/2/2014	14	2597	2609	-12	-0.00493167
2992	9/2/2014	15	2559	2814	-255	-0.099879907
2993	9/2/2014	16	2747	2825	-78	-0.028640889
2994	9/2/2014	17	2641	2726	-85	-0.032498112
2995	9/2/2014	18	2036	2078	-42	-0.020634423
2996	9/2/2014	19	1276	1231	45	0.034528127
2997	9/2/2014	20	680	704	-24	-0.036369495
2998	9/2/2014	21	350	378	-28	-0.08261125
2999	9/2/2014	22	209	221	-12	-0.061527077
3000	9/2/2014	23	155	134	21	0.130586161
3001	9/3/2014	0	166	196	-30	-0.184680227
3002	9/3/2014	1	423	357	66	0.154425511
3003	9/3/2014	2	357	769	-412	-1.155864508
3004	9/3/2014	3	383	679	-296	-0.774577679
3005	9/3/2014	4	627	785	-158	-0.252382872
3006	9/3/2014	5	870	1183	-313	-0.360141512
3007	9/3/2014	6	999	1454	-455	-0.456179142
3008	9/3/2014	7	946	1320	-374	-0.395415237
3009	9/3/2014	8	956	962	-6	-0.006386292
3010	9/3/2014	9	987	1248	-261	-0.265143856
3011	9/3/2014	10	1136	1328	-192	-0.169125966
3012	9/3/2014	11	1080	1310	-230	-0.213288407
3013	9/3/2014	12	1022	1182	-160	-0.157000391
3014	9/3/2014	13	962	1182	-220	-0.229039834
3015	9/3/2014	14	1305	1221	84	0.063876117
3016	9/3/2014	15	3038	1490	1548	0.509309012
3017	9/3/2014	16	2938	2960	-22	-0.00759341
3018	9/3/2014	17	1782	2664	-882	-0.494976762
3019	9/3/2014	18	1569	1320	249	0.158535367
3020	9/3/2014	19	1082	893	189	0.174223901
3021	9/3/2014	20	667	636	31	0.045545686
3022	9/3/2014	21	413	346	67	0.162064864
3023	9/3/2014	22	222	227	-5	-0.022881016
3024	9/3/2014	23	163	137	26	0.157377096
3025	9/4/2014	0	277	196	81	0.289971775
3026	9/4/2014	1	512	522	-10	-0.021328018
3027	9/4/2014	2	790	673	117	0.148085915
3028	9/4/2014	3	1334	1054	280	0.209675454
3029	9/4/2014	4	1945	1858	87	0.044549798
3030	9/4/2014	5	2693	2495	198	0.073299998
3031	9/4/2014	6	3081	2951	130	0.042095055
3032	9/4/2014	7	3099	2958	141	0.045440707
3033	9/4/2014	8	2527	2447	80	0.03129984
3034	9/4/2014	9	2576	2518	58	0.022280494
3035	9/4/2014	10	3495	2878	617	0.176512401
3036	9/4/2014	11	3323	3272	51	0.015083464
3037	9/4/2014	12	2970	2889	81	0.027151703
3038	9/4/2014	13	2650	2625	25	0.009183043
3039	9/4/2014	14	3025	2999	26	0.008434335
3040	9/4/2014	15	2994	3759	-765	-0.255671462
3041	9/4/2014	16	2953	3254	-301	-0.102148298
3042	9/4/2014	17	2967	2637	330	0.111127948
3043	9/4/2014	18	2321	2303	18	0.007518547
3044	9/4/2014	19	1236	1488	-252	-0.204193653
3045	9/4/2014	20	771	718	53	0.068200027
3046	9/4/2014	21	374	411	-37	-0.100634003
3047	9/4/2014	22	253	241	12	0.045853095
3048	9/4/2014	23	126	174	-48	-0.381909719
3049	9/5/2014	0	213	180	33	0.151216086
3050	9/5/2014	1	461	490	-29	-0.063096364
3051	9/5/2014	2	728	678	50	0.068071275
3052	9/5/2014	3	1178	1065	113	0.095562176
3053	9/5/2014	4	1783	1764	19	0.010492886
3054	9/5/2014	5	2333	2436	-103	-0.044279797
3055	9/5/2014	6	2842	2672	170	0.059544
3056	9/5/2014	7	2966	2749	217	0.073159132
3057	9/5/2014	8	2254	2446	-192	-0.085192009
3058	9/5/2014	9	2395	2459	-64	-0.026835375
3059	9/5/2014	10	2960	2741	219	0.073663582
3060	9/5/2014	11	2822	2785	37	0.01300109
3061	9/5/2014	12	2628	2576	52	0.019768289
3062	9/5/2014	13	2242	2350	-108	-0.048373933
3063	9/5/2014	14	2471	2501	-30	-0.012304791
3064	9/5/2014	15	2456	3092	-636	-0.259298265
3065	9/5/2014	16	2513	2640	-127	-0.050909774
3066	9/5/2014	17	2569	2297	272	0.105852389
3067	9/5/2014	18	2064	2119	-55	-0.026707049
3068	9/5/2014	19	1157	1227	-70	-0.061321407
3069	9/5/2014	20	673	672	1	4.65E-05
3070	9/5/2014	21	409	353	56	0.135231953
3071	9/5/2014	22	185	238	-53	-0.288571223
3072	9/5/2014	23	164	129	35	0.210764691
3073	9/6/2014	0	209	234	-25	-0.123085644
3074	9/6/2014	1	382	440	-58	-0.153957268
3075	9/6/2014	2	714	546	168	0.234498639
3076	9/6/2014	3	1068	1038	30	0.02764424
3077	9/6/2014	4	1592	1593	-1	-0.001193693
3078	9/6/2014	5	2251	2088	163	0.072255753
3079	9/6/2014	6	2686	2493	193	0.071715299
3080	9/6/2014	7	2829	2686	143	0.050463475
3081	9/6/2014	8	2419	2245	174	0.071922592
3082	9/6/2014	9	2446	2397	49	0.019879101
3083	9/6/2014	10	2681	2879	-198	-0.073945241
3084	9/6/2014	11	2917	2548	369	0.126387537
3085	9/6/2014	12	2441	2575	-134	-0.055064398
3086	9/6/2014	13	2346	2180	166	0.070457102
3087	9/6/2014	14	2546	2681	-135	-0.053179205
3088	9/6/2014	15	2517	3054	-537	-0.213505263
3089	9/6/2014	16	2396	2690	-294	-0.123035641
3090	9/6/2014	17	2407	2218	189	0.078347046
3091	9/6/2014	18	2018	2045	-27	-0.0135115
3092	9/6/2014	19	1411	1260	151	0.106954383
3093	9/6/2014	20	768	801	-33	-0.043279544
3094	9/6/2014	21	384	417	-33	-0.086004838
3095	9/6/2014	22	226	222	4	0.015690415
3096	9/6/2014	23	163	156	7	0.037056668
3097	9/7/2014	0	142	232	-90	-0.634421964
3098	9/7/2014	1	344	337	7	0.01976307
3099	9/7/2014	2	608	526	82	0.133291806
3100	9/7/2014	3	1019	947	72	0.069795629
3101	9/7/2014	4	1680	1586	94	0.055447073
3102	9/7/2014	5	2165	2148	17	0.007770208
3103	9/7/2014	6	2619	2465	154	0.058790198
3104	9/7/2014	7	2796	2574	222	0.079143065
3105	9/7/2014	8	2304	2288	16	0.006717988
3106	9/7/2014	9	2179	2332	-153	-0.070572503
3107	9/7/2014	10	2616	2612	4	0.001524552
3108	9/7/2014	11	2633	2551	82	0.031108115
3109	9/7/2014	12	2534	2396	138	0.054206164
3110	9/7/2014	13	2698	2276	422	0.156388397
3111	9/7/2014	14	2892	2923	-31	-0.011051617
3112	9/7/2014	15	2791	3321	-530	-0.190236648
3113	9/7/2014	16	2648	2681	-33	-0.01281082
3114	9/7/2014	17	2726	2427	299	0.109332958
3115	9/7/2014	18	2192	2307	-115	-0.052644429
3116	9/7/2014	19	1358	1330	28	0.020100632
3117	9/7/2014	20	691	777	-86	-0.125871455
3118	9/7/2014	21	395	388	7	0.016175783
3119	9/7/2014	22	203	219	-16	-0.082596934
3120	9/7/2014	23	84	147	-63	-0.750389488
3121	9/8/2014	0	184	130	54	0.289006687
3122	9/8/2014	1	355	388	-33	-0.093731973
3123	9/8/2014	2	643	656	-13	-0.020870124
3124	9/8/2014	3	1124	1068	56	0.049587157
3125	9/8/2014	4	1561	1647	-86	-0.055585015
3126	9/8/2014	5	2370	2177	193	0.081138536
3127	9/8/2014	6	2556	2771	-215	-0.084139509
3128	9/8/2014	7	1092	2699	-1607	-1.471657862
3129	9/8/2014	8	1054	1126	-72	-0.069204666
3130	9/8/2014	9	1078	1313	-235	-0.21811005
3131	9/8/2014	10	1130	1685	-555	-0.4919558
3132	9/8/2014	11	1140	1462	-322	-0.282570868
3133	9/8/2014	12	1051	1248	-197	-0.18819515
3134	9/8/2014	13	974	1222	-248	-0.255338447
3135	9/8/2014	14	1064	1311	-247	-0.232362251
3136	9/8/2014	15	1067	1232	-165	-0.155037072
3137	9/8/2014	16	1098	1239	-141	-0.129145245
3138	9/8/2014	17	996	1328	-332	-0.333814447
3139	9/8/2014	18	730	946	-216	-0.296585257
3140	9/8/2014	19	395	544	-149	-0.378168545
3141	9/8/2014	20	190	284	-94	-0.497660832
3142	9/8/2014	21	112	134	-22	-0.197687096
3143	9/8/2014	22	68	79	-11	-0.167617162
3144	9/8/2014	23	49	52	-3	-0.061489929
3145	9/9/2014	0	63	81	-18	-0.285920245
3146	9/9/2014	1	137	158	-21	-0.156478218
3147	9/9/2014	2	234	276	-42	-0.18048647
3148	9/9/2014	3	441	443	-2	-0.004978639
3149	9/9/2014	4	1360	782	578	0.424951619
3150	9/9/2014	5	2379	1798	581	0.244091607
3151	9/9/2014	6	3003	2495	508	0.169102671
3152	9/9/2014	7	3098	2170	928	0.299278771
3153	9/9/2014	8	2890	2126	764	0.26410181
3154	9/9/2014	9	3269	2433	836	0.255651952
3155	9/9/2014	10	3332	3154	178	0.05338783
3156	9/9/2014	11	3210	2908	302	0.093958421
3157	9/9/2014	12	2817	2582	235	0.083350645
3158	9/9/2014	13	2749	2460	289	0.104944536
3159	9/9/2014	14	2742	2763	-21	-0.007978869
3160	9/9/2014	15	3082	2566	516	0.167319903
3161	9/9/2014	16	3170	2795	375	0.118239773
3162	9/9/2014	17	3044	2839	205	0.067092992
3163	9/9/2014	18	2292	2228	64	0.027531007
3164	9/9/2014	19	1266	1249	17	0.01282849
3165	9/9/2014	20	687	631	56	0.080235982
3166	9/9/2014	21	464	375	89	0.189889825
3167	9/9/2014	22	266	230	36	0.13321653
3168	9/9/2014	23	136	159	-23	-0.169872399
3169	9/10/2014	0	201	178	23	0.113954071
3170	9/10/2014	1	520	384	136	0.260734993
3171	9/10/2014	2	805	864	-59	-0.074427996
3172	9/10/2014	3	1191	1346	-155	-0.130485043
3173	9/10/2014	4	1905	2066	-161	-0.084915216
3174	9/10/2014	5	2547	2941	-394	-0.154911909
3175	9/10/2014	6	3245	3285	-40	-0.012460624
3176	9/10/2014	7	3238	2732	506	0.156172823
3177	9/10/2014	8	2970	2902	68	0.02283894
3178	9/10/2014	9	3114	3004	110	0.035271673
3179	9/10/2014	10	3110	3191	-81	-0.026074258
3180	9/10/2014	11	3197	3056	141	0.044055967
3181	9/10/2014	12	2901	2824	77	0.02634045
3182	9/10/2014	13	2482	2792	-310	-0.125242143
3183	9/10/2014	14	2958	2669	289	0.097609438
3184	9/10/2014	15	2879	2936	-57	-0.020082158
3185	9/10/2014	16	2948	2848	100	0.033810948
3186	9/10/2014	17	2970	2835	135	0.045377635
3187	9/10/2014	18	2201	2178	23	0.010136829
3188	9/10/2014	19	1423	1282	141	0.098707654
3189	9/10/2014	20	694	709	-15	-0.022096947
3190	9/10/2014	21	373	389	-16	-0.043984802
3191	9/10/2014	22	245	207	38	0.15470971
3192	9/10/2014	23	160	133	27	0.168217509
3193	9/11/2014	0	249	201	48	0.189878163
3194	9/11/2014	1	452	498	-46	-0.103224591
3195	9/11/2014	2	761	706	55	0.071541993
3196	9/11/2014	3	1337	1167	170	0.126857181
3197	9/11/2014	4	1793	2303	-510	-0.284894666
3198	9/11/2014	5	2614	2619	-5	-0.002062686
3199	9/11/2014	6	3037	3108	-71	-0.023411786
3200	9/11/2014	7	3278	2658	620	0.189055933
3201	9/11/2014	8	3207	2875	332	0.10345877
3202	9/11/2014	9	3695	3031	664	0.179572139
3203	9/11/2014	10	3491	3450	41	0.011668748
3204	9/11/2014	11	3490	3149	341	0.097705515
3205	9/11/2014	12	3055	2925	130	0.04251923
3206	9/11/2014	13	2770	2719	51	0.018263208
3207	9/11/2014	14	2901	2882	19	0.006280762
3208	9/11/2014	15	3011	2871	140	0.046238619
3209	9/11/2014	16	3125	2931	194	0.06197208
3210	9/11/2014	17	3098	2896	202	0.065190026
3211	9/11/2014	18	2317	2263	54	0.022945998
3212	9/11/2014	19	1342	1298	44	0.032525185
3213	9/11/2014	20	658	637	21	0.031775661
3214	9/11/2014	21	379	376	3	0.006476575
3215	9/11/2014	22	206	219	-13	-0.063258734
3216	9/11/2014	23	203	115	88	0.429677398
3217	9/12/2014	0	245	284	-39	-0.162168595
3218	9/12/2014	1	396	482	-86	-0.218358039
3219	9/12/2014	2	869	636	233	0.26765729
3220	9/12/2014	3	1369	1373	-4	-0.003216498
3221	9/12/2014	4	1941	2403	-462	-0.238250606
3222	9/12/2014	5	2204	2928	-724	-0.328835484
3223	9/12/2014	6	3310	2799	511	0.15433317
3224	9/12/2014	7	3180	2924	256	0.080283993
3225	9/12/2014	8	2926	3095	-169	-0.057909664
3226	9/12/2014	9	3258	3137	121	0.037046379
3227	9/12/2014	10	3207	3097	110	0.034063403
3228	9/12/2014	11	3391	3170	221	0.065063003
3229	9/12/2014	12	3186	2937	249	0.077851546
3230	9/12/2014	13	2772	2773	-1	-0.000468673
3231	9/12/2014	14	3022	2915	107	0.035349675
3232	9/12/2014	15	2903	3012	-109	-0.037766641
3233	9/12/2014	16	3211	2956	255	0.079330269
3234	9/12/2014	17	2993	2996	-3	-0.001289258
3235	9/12/2014	18	2484	2199	285	0.114726985
3236	9/12/2014	19	1423	1379	44	0.030234685
3237	9/12/2014	20	770	667	103	0.132481668
3238	9/12/2014	21	384	424	-40	-0.104755356
3239	9/12/2014	22	294	223	71	0.241006653
3240	9/12/2014	23	200	186	14	0.065158036
3241	9/13/2014	0	214	251	-37	-0.173194848
3242	9/13/2014	1	394	419	-25	-0.065192314
3243	9/13/2014	2	815	682	133	0.162432213
3244	9/13/2014	3	1324	1332	-8	-0.006451672
3245	9/13/2014	4	1965	2227	-262	-0.133786059
3246	9/13/2014	5	2642	2689	-47	-0.018010868
3247	9/13/2014	6	3106	3391	-285	-0.091940041
3248	9/13/2014	7	3189	3313	-124	-0.038989514
3249	9/13/2014	8	3080	3091	-11	-0.003594672
3250	9/13/2014	9	3286	3458	-172	-0.052525024
3251	9/13/2014	10	3296	3311	-15	-0.004559576
3252	9/13/2014	11	3066	3367	-301	-0.098318645
3253	9/13/2014	12	2743	2847	-104	-0.03810613
3254	9/13/2014	13	2828	2566	262	0.092626771
3255	9/13/2014	14	2957	3061	-104	-0.03534808
3256	9/13/2014	15	2809	3055	-246	-0.087870896
3257	9/13/2014	16	2942	2953	-11	-0.003968852
3258	9/13/2014	17	2806	2943	-137	-0.049174955
3259	9/13/2014	18	2088	2249	-161	-0.077433913
3260	9/13/2014	19	1585	1263	322	0.202645776
3261	9/13/2014	20	930	791	139	0.148825952
3262	9/13/2014	21	443	501	-58	-0.132766071
3263	9/13/2014	22	327	268	59	0.180101834
3264	9/13/2014	23	200	209	-9	-0.048766446
